,customer_id,recency,frequency,monetary_value,R,F,M,rfm_score,RFM_level
0,1,8,11,9084.449999999999,4,4,4,12,Highly potential
1,2,129,3,4149.07,1,1,2,4,Needs Attention
2,5,17,6,5903.2,4,3,3,10,Highly potential
3,8,23,9,9933.289999999999,3,4,4,11,Highly potential
4,9,79,6,5357.55,2,3,2,7,Require Activation
5,12,68,7,6394.21,2,3,3,8,Require Activation
6,13,28,7,7734.740000000001,3,3,3,9,Highly potential
7,14,48,3,2509.3900000000003,2,1,1,4,Needs Attention
8,15,36,6,4923.339999999999,3,3,2,8,Require Activation
9,16,100,5,7763.79,1,2,3,6,Loyal
10,17,1,5,4676.1900000000005,4,2,2,8,Require Activation
11,18,135,7,8878.62,1,3,4,8,Require Activation
12,19,281,2,2948.34,1,1,1,3,Require Activation
13,20,32,4,6618.860000000001,3,1,3,7,Require Activation
14,21,7,5,7446.209999999999,4,2,3,9,Highly potential
15,24,18,7,6885.51,4,3,3,10,Highly potential
16,25,6,12,9996.33,4,4,4,12,Highly potential
17,26,260,2,2245.85,1,1,1,3,Require Activation
18,27,144,7,7679.97,1,3,3,7,Require Activation
19,28,84,6,5492.900000000001,2,3,2,7,Require Activation
20,29,23,9,10855.57,3,4,4,11,Highly potential
21,31,90,4,3109.9999999999995,1,1,1,3,Require Activation
22,32,139,7,7873.18,1,3,3,7,Require Activation
23,33,39,7,9384.23,3,3,4,10,Highly potential
24,34,103,8,12098.830000000002,1,4,4,9,Highly potential
25,35,93,4,4182.28,1,1,2,4,Needs Attention
26,36,164,2,1781.04,1,1,1,3,Require Activation
27,37,8,9,11291.71,4,4,4,12,Highly potential
28,38,51,4,4502.59,2,1,2,5,Promising
29,39,35,12,11237.19,3,4,4,11,Highly potential
30,40,15,5,4882.43,4,2,2,8,Require Activation
31,41,30,9,9114.150000000001,3,4,4,11,Highly potential
32,42,112,4,1936.46,1,1,1,3,Require Activation
33,43,62,9,6574.59,2,4,3,9,Highly potential
34,44,36,7,7497.399999999999,3,3,3,9,Highly potential
35,45,44,3,2912.33,3,1,1,5,Promising
36,47,36,7,8022.01,3,3,4,10,Highly potential
37,48,83,8,9654.119999999999,2,4,4,10,Highly potential
38,49,37,4,5637.490000000001,3,1,2,6,Loyal
39,50,27,7,7362.2699999999995,3,3,3,9,Highly potential
40,51,56,8,9667.460000000003,2,4,4,10,Highly potential
41,53,8,5,5472.74,4,2,2,8,Require Activation
42,54,68,7,9813.66,2,3,4,9,Highly potential
43,55,47,8,6754.209999999999,2,4,3,9,Highly potential
44,56,3,7,5060.86,4,3,2,9,Highly potential
45,57,36,6,8748.75,3,3,4,10,Highly potential
46,58,21,8,6967.3099999999995,3,4,3,10,Highly potential
47,59,23,3,2797.47,3,1,1,5,Promising
48,61,48,6,7529.360000000001,2,3,3,8,Require Activation
49,63,69,3,4156.66,2,1,2,5,Promising
50,64,4,5,4111.12,4,2,2,8,Require Activation
51,65,137,5,6421.17,1,2,3,6,Loyal
52,66,44,5,6489.33,3,2,3,8,Require Activation
53,68,85,3,5127.98,2,1,2,5,Promising
54,69,21,6,8395.75,3,3,4,10,Highly potential
55,70,5,5,4801.11,4,2,2,8,Require Activation
56,71,132,1,1415.01,1,1,1,3,Require Activation
57,72,23,4,4048.85,3,1,1,5,Promising
58,73,169,6,5265.87,1,3,2,6,Loyal
59,75,61,8,7130.63,2,4,3,9,Highly potential
60,76,2,8,7425.04,4,4,3,11,Highly potential
61,77,102,3,2964.73,1,1,1,3,Require Activation
62,78,212,2,1139.12,1,1,1,3,Require Activation
63,79,48,5,4918.51,2,2,2,6,Loyal
64,80,29,10,12564.820000000002,3,4,4,11,Highly potential
65,82,79,5,5293.91,2,2,2,6,Loyal
66,83,81,6,4464.650000000001,2,3,2,7,Require Activation
67,84,29,7,5464.65,3,3,2,8,Require Activation
68,85,38,6,3158.6299999999997,3,3,1,7,Require Activation
69,86,1,9,7319.349999999999,4,4,3,11,Highly potential
70,87,19,9,7994.73,4,4,3,11,Highly potential
71,88,75,6,5550.83,2,3,2,7,Require Activation
72,89,5,9,12741.44,4,4,4,12,Highly potential
73,90,31,7,7703.580000000001,3,3,3,9,Highly potential
74,91,10,8,8066.4400000000005,4,4,4,12,Highly potential
75,92,35,3,5098.43,3,1,2,6,Loyal
76,93,80,3,5276.13,2,1,2,5,Promising
77,94,34,7,8305.77,3,3,4,10,Highly potential
78,95,39,4,5049.799999999999,3,1,2,6,Loyal
79,96,71,3,2783.33,2,1,1,4,Needs Attention
80,97,103,8,8895.95,1,4,4,9,Highly potential
81,98,142,4,5405.52,1,1,2,4,Needs Attention
82,99,3,9,8279.06,4,4,4,12,Highly potential
83,100,12,2,2748.2,4,1,1,6,Loyal
84,101,9,4,4309.82,4,1,2,7,Require Activation
85,102,43,7,6659.219999999999,3,3,3,9,Highly potential
86,103,117,4,4838.35,1,1,2,4,Needs Attention
87,104,65,7,6361.89,2,3,3,8,Require Activation
88,105,90,4,6234.35,1,1,3,5,Promising
89,107,82,4,3345.1000000000004,2,1,1,4,Needs Attention
90,109,9,10,10661.51,4,4,4,12,Highly potential
91,111,148,4,4873.0599999999995,1,1,2,4,Needs Attention
92,112,48,6,9059.890000000001,2,3,4,9,Highly potential
93,113,176,6,5412.969999999999,1,3,2,6,Loyal
94,114,71,4,3233.0,2,1,1,4,Needs Attention
95,115,15,8,8398.18,4,4,4,12,Highly potential
96,116,13,8,5663.920000000001,4,4,2,10,Highly potential
97,117,6,10,12856.83,4,4,4,12,Highly potential
98,118,70,5,5319.51,2,2,2,6,Loyal
99,119,31,4,5217.66,3,1,2,6,Loyal
100,120,130,2,2173.3,1,1,1,3,Require Activation
101,121,112,4,4327.4400000000005,1,1,2,4,Needs Attention
102,122,9,5,6533.39,4,2,3,9,Highly potential
103,123,192,4,5337.790000000001,1,1,2,4,Needs Attention
104,124,3,7,8272.15,4,3,4,11,Highly potential
105,125,84,10,7107.32,2,4,3,9,Highly potential
106,126,12,3,3448.12,4,1,1,6,Loyal
107,127,24,10,9949.619999999999,3,4,4,11,Highly potential
108,128,138,4,3679.75,1,1,1,3,Require Activation
109,129,179,4,4090.48,1,1,1,3,Require Activation
110,130,77,2,3340.42,2,1,1,4,Needs Attention
111,131,206,6,8745.28,1,3,4,8,Require Activation
112,132,8,6,7365.93,4,3,3,10,Highly potential
113,133,27,5,3164.55,3,2,1,6,Loyal
114,134,15,6,7170.95,4,3,3,10,Highly potential
115,135,116,7,6860.460000000001,1,3,3,7,Require Activation
116,136,21,8,9406.85,3,4,4,11,Highly potential
117,137,28,5,3507.0499999999997,3,2,1,6,Loyal
118,138,65,7,4927.349999999999,2,3,2,7,Require Activation
119,140,4,6,7649.339999999999,4,3,3,10,Highly potential
120,141,160,3,4053.9800000000005,1,1,1,3,Require Activation
121,142,5,11,12474.740000000002,4,4,4,12,Highly potential
122,143,14,4,4689.21,4,1,2,7,Require Activation
123,145,29,7,8149.189999999999,3,3,4,10,Highly potential
124,146,195,2,1973.29,1,1,1,3,Require Activation
125,147,35,6,8079.089999999999,3,3,4,10,Highly potential
126,148,44,5,5808.83,3,2,2,7,Require Activation
127,149,19,4,4945.6900000000005,4,1,2,7,Require Activation
128,150,76,4,3630.96,2,1,1,4,Needs Attention
129,151,1,7,11422.85,4,3,4,11,Highly potential
130,152,159,2,2941.37,1,1,1,3,Require Activation
131,153,65,7,7808.16,2,3,3,8,Require Activation
132,154,24,5,3521.53,3,2,1,6,Loyal
133,155,9,3,4008.51,4,1,1,6,Loyal
134,156,17,5,4831.579999999999,4,2,2,8,Require Activation
135,157,136,3,1748.4899999999998,1,1,1,3,Require Activation
136,158,66,6,7221.049999999999,2,3,3,8,Require Activation
137,159,67,6,6016.320000000001,2,3,3,8,Require Activation
138,160,94,2,3024.58,1,1,1,3,Require Activation
139,162,99,3,3317.47,1,1,1,3,Require Activation
140,163,115,2,3089.24,1,1,1,3,Require Activation
141,164,199,3,2583.85,1,1,1,3,Require Activation
142,165,9,8,9603.13,4,4,4,12,Highly potential
143,166,64,7,8521.58,2,3,4,9,Highly potential
144,169,62,3,2065.08,2,1,1,4,Needs Attention
145,170,235,3,3684.75,1,1,1,3,Require Activation
146,171,19,8,9347.85,4,4,4,12,Highly potential
147,172,12,7,9250.22,4,3,4,11,Highly potential
148,173,16,9,14061.479999999998,4,4,4,12,Highly potential
149,174,12,10,12893.570000000002,4,4,4,12,Highly potential
150,175,65,5,6008.03,2,2,3,7,Require Activation
151,176,23,4,6146.7,3,1,3,7,Require Activation
152,177,38,12,11826.34,3,4,4,11,Highly potential
153,179,41,3,3168.84,3,1,1,5,Promising
154,180,12,7,7970.57,4,3,3,10,Highly potential
155,181,51,5,4262.27,2,2,2,6,Loyal
156,182,14,7,9279.01,4,3,4,11,Highly potential
157,183,103,6,5947.98,1,3,3,7,Require Activation
158,184,33,3,3734.88,3,1,1,5,Promising
159,186,24,6,5550.85,3,3,2,8,Require Activation
160,187,15,7,6898.790000000001,4,3,3,10,Highly potential
161,188,16,6,5126.07,4,3,2,9,Highly potential
162,189,4,5,8633.689999999999,4,2,4,10,Highly potential
163,190,30,4,3083.07,3,1,1,5,Promising
164,191,106,1,1065.03,1,1,1,3,Require Activation
165,192,80,4,3836.29,2,1,1,4,Needs Attention
166,193,25,5,7368.359999999999,3,2,3,8,Require Activation
167,194,109,3,4313.530000000001,1,1,2,4,Needs Attention
168,195,1,7,12479.459999999997,4,3,4,11,Highly potential
169,196,147,8,6346.610000000001,1,4,3,8,Require Activation
170,198,59,9,11648.85,2,4,4,10,Highly potential
171,199,16,4,4323.860000000001,4,1,2,7,Require Activation
172,200,8,9,11117.36,4,4,4,12,Highly potential
173,201,29,8,9167.380000000001,3,4,4,11,Highly potential
174,202,19,3,2511.82,4,1,1,6,Loyal
175,203,12,5,4376.259999999999,4,2,2,8,Require Activation
176,204,28,8,11444.0,3,4,4,11,Highly potential
177,205,53,9,6904.879999999999,2,4,3,9,Highly potential
178,206,78,4,5633.8099999999995,2,1,2,5,Promising
179,208,28,5,5158.98,3,2,2,7,Require Activation
180,209,108,5,6093.4800000000005,1,2,3,6,Loyal
181,210,23,6,8805.199999999999,3,3,4,10,Highly potential
182,212,188,2,2429.8,1,1,1,3,Require Activation
183,213,29,10,11681.589999999998,3,4,4,11,Highly potential
184,214,57,5,5776.950000000001,2,2,2,6,Loyal
185,215,4,8,8485.16,4,4,4,12,Highly potential
186,216,17,4,4801.610000000001,4,1,2,7,Require Activation
187,218,15,4,3125.6,4,1,1,6,Loyal
188,219,41,6,6156.27,3,3,3,9,Highly potential
189,220,16,6,7458.69,4,3,3,10,Highly potential
190,221,19,6,6729.84,4,3,3,10,Highly potential
191,222,21,2,2626.81,3,1,1,5,Promising
192,223,53,6,8743.94,2,3,4,9,Highly potential
193,224,2,6,6209.459999999999,4,3,3,10,Highly potential
194,225,38,3,2416.13,3,1,1,5,Promising
195,226,117,2,1639.95,1,1,1,3,Require Activation
196,227,27,5,5589.13,3,2,2,7,Require Activation
197,228,78,5,5178.17,2,2,2,6,Loyal
198,230,37,11,11755.6,3,4,4,11,Highly potential
199,231,46,4,5338.64,2,1,2,5,Promising
200,232,142,6,4132.44,1,3,2,6,Loyal
201,233,18,6,5218.620000000001,4,3,2,9,Highly potential
202,234,12,9,11070.19,4,4,4,12,Highly potential
203,235,3,11,9629.609999999999,4,4,4,12,Highly potential
204,236,7,4,5255.34,4,1,2,7,Require Activation
205,237,27,8,7156.79,3,4,3,10,Highly potential
206,238,108,5,5838.6,1,2,2,5,Promising
207,239,2,9,12986.130000000001,4,4,4,12,Highly potential
208,240,89,6,5689.530000000001,2,3,2,7,Require Activation
209,241,48,4,3855.87,2,1,1,4,Needs Attention
210,242,132,7,7798.25,1,3,3,7,Require Activation
211,243,75,5,6741.570000000001,2,2,3,7,Require Activation
212,245,13,5,4855.26,4,2,2,8,Require Activation
213,246,28,9,9724.98,3,4,4,11,Highly potential
214,247,113,7,9778.37,1,3,4,8,Require Activation
215,248,135,7,8902.16,1,3,4,8,Require Activation
216,249,48,9,6569.139999999999,2,4,3,9,Highly potential
217,252,63,5,5565.48,2,2,2,6,Loyal
218,253,18,5,2932.39,4,2,1,7,Require Activation
219,254,42,7,9801.07,3,3,4,10,Highly potential
220,255,58,11,14027.76,2,4,4,10,Highly potential
221,256,1,5,5861.16,4,2,2,8,Require Activation
222,258,19,5,4816.4,4,2,2,8,Require Activation
223,259,28,4,5329.9400000000005,3,1,2,6,Loyal
224,260,9,9,8587.0,4,4,4,12,Highly potential
225,261,51,9,9137.670000000002,2,4,4,10,Highly potential
226,263,47,7,7902.84,2,3,3,8,Require Activation
227,264,49,4,2339.86,2,1,1,4,Needs Attention
228,265,80,4,4809.139999999999,2,1,2,5,Promising
229,266,33,4,4191.43,3,1,2,6,Loyal
230,268,70,4,5104.56,2,1,2,5,Promising
231,269,169,5,5215.37,1,2,2,5,Promising
232,270,8,7,7413.61,4,3,3,10,Highly potential
233,271,203,2,2293.0200000000004,1,1,1,3,Require Activation
234,272,92,7,7345.169999999999,1,3,3,7,Require Activation
235,273,29,10,11372.240000000002,3,4,4,11,Highly potential
236,274,150,4,2597.6800000000003,1,1,1,3,Require Activation
237,277,22,3,3580.48,3,1,1,5,Promising
238,278,249,1,1228.07,1,1,1,3,Require Activation
239,279,15,6,3817.17,4,3,1,8,Require Activation
240,280,44,10,10822.28,3,4,4,11,Highly potential
241,281,10,4,3537.46,4,1,1,6,Loyal
242,282,70,2,2565.84,2,1,1,4,Needs Attention
243,283,92,5,7164.45,1,2,3,6,Loyal
244,284,134,5,5874.839999999999,1,2,2,5,Promising
245,285,8,6,6725.29,4,3,3,10,Highly potential
246,286,138,4,6402.06,1,1,3,5,Promising
247,287,139,1,2083.94,1,1,1,3,Require Activation
248,289,45,9,9320.12,3,4,4,11,Highly potential
249,291,41,2,983.55,3,1,1,5,Promising
250,292,59,7,8825.97,2,3,4,9,Highly potential
251,293,11,5,5175.56,4,2,2,8,Require Activation
252,294,116,7,8719.14,1,3,4,8,Require Activation
253,295,35,7,5956.460000000001,3,3,3,9,Highly potential
254,297,9,4,5674.71,4,1,2,7,Require Activation
255,298,9,9,10336.31,4,4,4,12,Highly potential
256,299,93,7,10296.119999999999,1,3,4,8,Require Activation
257,300,157,5,7003.74,1,2,3,6,Loyal
258,301,94,2,361.78,1,1,1,3,Require Activation
259,303,44,3,3874.1800000000003,3,1,1,5,Promising
260,304,81,9,7284.7,2,4,3,9,Highly potential
261,305,34,6,5206.259999999999,3,3,2,8,Require Activation
262,306,124,2,1362.46,1,1,1,3,Require Activation
263,307,16,9,9818.0,4,4,4,12,Highly potential
264,308,26,6,7432.0199999999995,3,3,3,9,Highly potential
265,309,10,4,5475.93,4,1,2,7,Require Activation
266,310,9,7,9065.04,4,3,4,11,Highly potential
267,311,62,6,7559.0599999999995,2,3,3,8,Require Activation
268,312,14,5,6921.420000000001,4,2,3,9,Highly potential
269,313,18,6,8979.0,4,3,4,11,Highly potential
270,314,21,8,6264.7300000000005,3,4,3,10,Highly potential
271,315,28,9,7677.51,3,4,3,10,Highly potential
272,316,12,4,3813.84,4,1,1,6,Loyal
273,317,81,4,5779.95,2,1,2,5,Promising
274,318,10,7,9276.070000000002,4,3,4,11,Highly potential
275,320,13,10,11721.06,4,4,4,12,Highly potential
276,321,13,5,5405.99,4,2,2,8,Require Activation
277,322,2,11,14770.22,4,4,4,12,Highly potential
278,323,36,6,4992.110000000001,3,3,2,8,Require Activation
279,324,22,5,2711.1399999999994,3,2,1,6,Loyal
280,325,134,6,7543.920000000001,1,3,3,7,Require Activation
281,326,162,3,3419.08,1,1,1,3,Require Activation
282,327,17,5,6108.209999999999,4,2,3,9,Highly potential
283,328,5,8,5739.529999999999,4,4,2,10,Highly potential
284,329,35,6,5425.24,3,3,2,8,Require Activation
285,330,108,6,8513.199999999999,1,3,4,8,Require Activation
286,331,83,6,7052.26,2,3,3,8,Require Activation
287,332,264,2,1362.46,1,1,1,3,Require Activation
288,333,23,6,5889.4,3,3,3,9,Highly potential
289,334,57,6,6125.9,2,3,3,8,Require Activation
290,335,25,2,2234.34,3,1,1,5,Promising
291,337,38,6,5855.57,3,3,2,8,Require Activation
292,339,59,5,6459.18,2,2,3,7,Require Activation
293,341,135,2,3532.9399999999996,1,1,1,3,Require Activation
294,342,94,3,1960.04,1,1,1,3,Require Activation
295,343,104,9,10377.999999999998,1,4,4,9,Highly potential
296,345,20,7,7446.1399999999985,3,3,3,9,Highly potential
297,346,13,9,8874.36,4,4,4,12,Highly potential
298,347,60,7,12360.26,2,3,4,9,Highly potential
299,348,126,6,5562.58,1,3,2,6,Loyal
300,349,167,5,4619.93,1,2,2,5,Promising
301,350,5,6,4728.13,4,3,2,9,Highly potential
302,351,12,2,2832.11,4,1,1,6,Loyal
303,352,26,6,8533.27,3,3,4,10,Highly potential
304,353,24,11,13721.089999999998,3,4,4,11,Highly potential
305,354,68,6,5392.109999999999,2,3,2,7,Require Activation
306,355,46,5,4674.0199999999995,2,2,2,6,Loyal
307,357,16,8,8779.220000000001,4,4,4,12,Highly potential
308,358,71,2,2129.82,2,1,1,4,Needs Attention
309,359,9,10,8564.63,4,4,4,12,Highly potential
310,360,9,5,6069.39,4,2,3,9,Highly potential
311,361,147,7,6592.67,1,3,3,7,Require Activation
312,362,90,4,1612.5100000000002,1,1,1,3,Require Activation
313,363,15,6,11621.14,4,3,4,11,Highly potential
314,364,12,6,6791.39,4,3,3,10,Highly potential
315,365,51,7,8188.290000000001,2,3,4,9,Highly potential
316,366,116,6,5867.110000000001,1,3,2,6,Loyal
317,367,44,5,5068.58,3,2,2,7,Require Activation
318,369,102,8,9536.349999999999,1,4,4,9,Highly potential
319,371,10,5,6859.800000000001,4,2,3,9,Highly potential
320,372,32,8,6870.42,3,4,3,10,Highly potential
321,373,224,1,1466.68,1,1,1,3,Require Activation
322,374,14,6,7756.64,4,3,3,10,Highly potential
323,375,92,4,3460.33,1,1,1,3,Require Activation
324,376,44,3,1981.8899999999999,3,1,1,5,Promising
325,377,7,11,9343.58,4,4,4,12,Highly potential
326,378,125,7,5827.91,1,3,2,6,Loyal
327,380,36,8,10261.59,3,4,4,11,Highly potential
328,381,3,8,8019.800000000001,4,4,3,11,Highly potential
329,382,36,7,6536.92,3,3,3,9,Highly potential
330,383,52,3,3922.8999999999996,2,1,1,4,Needs Attention
331,385,79,9,10758.23,2,4,4,10,Highly potential
332,386,67,5,5445.4400000000005,2,2,2,6,Loyal
333,387,32,3,5303.1,3,1,2,6,Loyal
334,389,114,6,3948.4300000000003,1,3,1,5,Promising
335,390,77,5,2855.2200000000003,2,2,1,5,Promising
336,392,102,7,8157.6,1,3,4,8,Require Activation
337,393,147,2,2728.3599999999997,1,1,1,3,Require Activation
338,394,46,8,7818.74,2,4,3,9,Highly potential
339,395,31,6,6571.34,3,3,3,9,Highly potential
340,396,30,6,6560.6900000000005,3,3,3,9,Highly potential
341,397,46,5,3791.0999999999995,2,2,1,5,Promising
342,399,50,6,7848.56,2,3,3,8,Require Activation
343,400,135,5,4266.01,1,2,2,5,Promising
344,401,30,7,7478.679999999999,3,3,3,9,Highly potential
345,402,57,6,8148.219999999999,2,3,4,9,Highly potential
346,403,57,5,4228.44,2,2,2,6,Loyal
347,404,19,8,9102.38,4,4,4,12,Highly potential
348,406,107,5,5322.950000000001,1,2,2,5,Promising
349,407,10,9,7837.83,4,4,3,11,Highly potential
350,408,18,5,5252.97,4,2,2,8,Require Activation
351,409,14,4,3610.1099999999997,4,1,1,6,Loyal
352,410,7,7,5472.9,4,3,2,9,Highly potential
353,411,188,5,5130.24,1,2,2,5,Promising
354,413,168,5,5306.63,1,2,2,5,Promising
355,414,48,6,4770.45,2,3,2,7,Require Activation
356,415,249,2,3670.0,1,1,1,3,Require Activation
357,416,89,5,4670.05,2,2,2,6,Loyal
358,417,71,7,8689.25,2,3,4,9,Highly potential
359,419,15,7,7917.429999999999,4,3,3,10,Highly potential
360,420,60,10,11080.54,2,4,4,10,Highly potential
361,421,57,6,7222.93,2,3,3,8,Require Activation
362,423,142,5,5058.62,1,2,2,5,Promising
363,424,75,7,9036.619999999999,2,3,4,9,Highly potential
364,425,26,7,10925.23,3,3,4,10,Highly potential
365,426,60,8,8616.47,2,4,4,10,Highly potential
366,427,110,4,4678.55,1,1,2,4,Needs Attention
367,428,52,8,9009.45,2,4,4,10,Highly potential
368,429,19,8,8631.57,4,4,4,12,Highly potential
369,430,66,6,7494.51,2,3,3,8,Require Activation
370,431,139,1,1289.85,1,1,1,3,Require Activation
371,432,22,8,9237.06,3,4,4,11,Highly potential
372,433,16,9,10236.83,4,4,4,12,Highly potential
373,435,103,4,5669.1,1,1,2,4,Needs Attention
374,436,51,3,3374.59,2,1,1,4,Needs Attention
375,437,49,6,5595.76,2,3,2,7,Require Activation
376,438,52,8,12777.29,2,4,4,10,Highly potential
377,439,100,5,5412.13,1,2,2,5,Promising
378,440,12,8,7773.049999999999,4,4,3,11,Highly potential
379,441,63,3,2910.7200000000003,2,1,1,4,Needs Attention
380,444,46,7,7147.110000000001,2,3,3,8,Require Activation
381,445,25,11,14593.22,3,4,4,11,Highly potential
382,446,53,8,10683.109999999999,2,4,4,10,Highly potential
383,447,1,5,6275.040000000001,4,2,3,9,Highly potential
384,448,189,4,4424.38,1,1,2,4,Needs Attention
385,449,134,6,6240.950000000001,1,3,3,7,Require Activation
386,450,83,4,5369.549999999999,2,1,2,5,Promising
387,452,25,5,3872.43,3,2,1,6,Loyal
388,455,68,3,4076.17,2,1,1,4,Needs Attention
389,456,89,5,6261.639999999999,2,2,3,7,Require Activation
390,457,116,5,6553.52,1,2,3,6,Loyal
391,458,27,5,3615.63,3,2,1,6,Loyal
392,459,39,5,6449.129999999999,3,2,3,8,Require Activation
393,461,21,8,10366.86,3,4,4,11,Highly potential
394,463,60,7,7679.469999999999,2,3,3,8,Require Activation
395,465,5,6,4766.91,4,3,2,9,Highly potential
396,467,170,6,7065.390000000001,1,3,3,7,Require Activation
397,468,95,6,7264.859999999999,1,3,3,7,Require Activation
398,469,102,10,7566.66,1,4,3,8,Require Activation
399,470,10,7,7158.48,4,3,3,10,Highly potential
400,471,49,6,6243.619999999999,2,3,3,8,Require Activation
401,472,50,5,5989.660000000001,2,2,3,7,Require Activation
402,473,116,9,12033.62,1,4,4,9,Highly potential
403,474,98,2,2107.8199999999997,1,1,1,3,Require Activation
404,476,10,4,4416.900000000001,4,1,2,7,Require Activation
405,477,36,5,5899.43,3,2,3,8,Require Activation
406,478,4,9,8880.93,4,4,4,12,Highly potential
407,481,15,2,2156.44,4,1,1,6,Loyal
408,483,41,7,8372.109999999999,3,3,4,10,Highly potential
409,484,20,5,5694.35,3,2,2,7,Require Activation
410,485,15,6,5662.31,4,3,2,9,Highly potential
411,486,92,5,7323.58,1,2,3,6,Loyal
412,487,140,2,1875.15,1,1,1,3,Require Activation
413,488,28,7,4859.099999999999,3,3,2,8,Require Activation
414,489,125,5,5450.6900000000005,1,2,2,5,Promising
415,490,54,9,9886.75,2,4,4,10,Highly potential
416,491,69,7,6140.67,2,3,3,8,Require Activation
417,492,90,4,5248.150000000001,1,1,2,4,Needs Attention
418,493,76,3,607.78,2,1,1,4,Needs Attention
419,495,129,6,6120.139999999999,1,3,3,7,Require Activation
420,496,46,4,3612.1900000000005,2,1,1,4,Needs Attention
421,498,8,7,9834.95,4,3,4,11,Highly potential
422,499,56,11,8960.43,2,4,4,10,Highly potential
423,500,25,8,9381.92,3,4,4,11,Highly potential
424,501,183,3,2476.2,1,1,1,3,Require Activation
425,502,167,4,3572.03,1,1,1,3,Require Activation
426,503,84,3,2643.58,2,1,1,4,Needs Attention
427,504,137,8,7145.669999999999,1,4,3,8,Require Activation
428,506,57,10,14208.249999999998,2,4,4,10,Highly potential
429,508,156,4,5351.73,1,1,2,4,Needs Attention
430,509,90,6,6017.45,1,3,3,7,Require Activation
431,511,12,5,4598.6900000000005,4,2,2,8,Require Activation
432,512,96,4,4233.95,1,1,2,4,Needs Attention
433,515,15,8,11033.65,4,4,4,12,Highly potential
434,516,20,10,9021.7,3,4,4,11,Highly potential
435,517,11,6,5083.11,4,3,2,9,Highly potential
436,518,262,3,3288.99,1,1,1,3,Require Activation
437,520,17,5,2566.04,4,2,1,7,Require Activation
438,521,155,2,1849.5700000000002,1,1,1,3,Require Activation
439,523,19,6,6485.21,4,3,3,10,Highly potential
440,524,139,7,6400.86,1,3,3,7,Require Activation
441,525,120,8,10372.679999999998,1,4,4,9,Highly potential
442,527,44,2,2476.84,3,1,1,5,Promising
443,528,135,7,7737.110000000001,1,3,3,7,Require Activation
444,529,13,6,6036.22,4,3,3,10,Highly potential
445,530,163,3,2816.79,1,1,1,3,Require Activation
446,531,62,5,4164.33,2,2,2,6,Loyal
447,532,29,5,5725.47,3,2,2,7,Require Activation
448,533,3,6,8210.1,4,3,4,11,Highly potential
449,534,7,8,8223.81,4,4,4,12,Highly potential
450,536,33,3,3876.2299999999996,3,1,1,5,Promising
451,537,50,3,2906.29,2,1,1,4,Needs Attention
452,538,5,7,8944.21,4,3,4,11,Highly potential
453,540,80,6,4419.63,2,3,2,7,Require Activation
454,542,39,6,6399.45,3,3,3,9,Highly potential
455,543,1,5,4605.8,4,2,2,8,Require Activation
456,544,174,4,4228.66,1,1,2,4,Needs Attention
457,545,7,6,8697.359999999999,4,3,4,11,Highly potential
458,546,38,5,7164.9,3,2,3,8,Require Activation
459,547,75,6,5913.530000000001,2,3,3,8,Require Activation
460,549,41,8,7971.78,3,4,3,10,Highly potential
461,551,153,4,3722.38,1,1,1,3,Require Activation
462,552,160,4,2960.2700000000004,1,1,1,3,Require Activation
463,553,20,6,6913.18,3,3,3,9,Highly potential
464,554,39,3,2306.3799999999997,3,1,1,5,Promising
465,555,166,4,5261.7300000000005,1,1,2,4,Needs Attention
466,556,10,5,6960.33,4,2,3,9,Highly potential
467,558,36,6,5672.88,3,3,2,8,Require Activation
468,559,7,4,4129.679999999999,4,1,2,7,Require Activation
469,560,42,6,7033.259999999999,3,3,3,9,Highly potential
470,561,29,6,5776.22,3,3,2,8,Require Activation
471,562,37,5,3686.9400000000005,3,2,1,6,Loyal
472,563,34,7,5492.75,3,3,2,8,Require Activation
473,564,12,6,7415.539999999999,4,3,3,10,Highly potential
474,565,105,10,12454.339999999998,1,4,4,9,Highly potential
475,566,53,3,2893.23,2,1,1,4,Needs Attention
476,568,92,7,5025.95,1,3,2,6,Loyal
477,569,99,4,7560.33,1,1,3,5,Promising
478,570,36,6,6987.99,3,3,3,9,Highly potential
479,571,73,3,3718.5299999999997,2,1,1,4,Needs Attention
480,572,14,6,5372.65,4,3,2,9,Highly potential
481,573,106,2,2449.81,1,1,1,3,Require Activation
482,574,278,4,4757.79,1,1,2,4,Needs Attention
483,575,249,2,1998.31,1,1,1,3,Require Activation
484,576,8,6,9475.419999999998,4,3,4,11,Highly potential
485,578,200,7,6301.1,1,3,3,7,Require Activation
486,579,53,9,10450.340000000002,2,4,4,10,Highly potential
487,580,25,5,4456.28,3,2,2,7,Require Activation
488,581,54,4,5597.1900000000005,2,1,2,5,Promising
489,583,32,4,4129.98,3,1,2,6,Loyal
490,584,133,4,3399.52,1,1,1,3,Require Activation
491,585,98,6,6998.679999999999,1,3,3,7,Require Activation
492,586,91,3,4165.02,1,1,2,4,Needs Attention
493,587,54,6,6833.5599999999995,2,3,3,8,Require Activation
494,588,20,5,6053.33,3,2,3,8,Require Activation
495,589,11,3,3259.93,4,1,1,6,Loyal
496,590,44,11,13200.689999999999,3,4,4,11,Highly potential
497,591,222,2,1083.8,1,1,1,3,Require Activation
498,592,200,4,3192.9399999999996,1,1,1,3,Require Activation
499,593,2,6,5682.7699999999995,4,3,2,9,Highly potential
500,594,34,9,11996.119999999999,3,4,4,11,Highly potential
501,595,185,3,3268.42,1,1,1,3,Require Activation
502,596,86,3,4864.710000000001,2,1,2,5,Promising
503,597,62,5,4299.400000000001,2,2,2,6,Loyal
504,598,132,7,5976.1900000000005,1,3,3,7,Require Activation
505,600,207,3,3893.54,1,1,1,3,Require Activation
506,601,59,5,5216.139999999999,2,2,2,6,Loyal
507,602,78,5,5591.280000000001,2,2,2,6,Loyal
508,603,50,7,8284.07,2,3,4,9,Highly potential
509,604,70,6,8162.76,2,3,4,9,Highly potential
510,605,3,8,9180.130000000001,4,4,4,12,Highly potential
511,606,56,6,6229.089999999999,2,3,3,8,Require Activation
512,607,59,10,12940.990000000002,2,4,4,10,Highly potential
513,608,86,8,9260.289999999999,2,4,4,10,Highly potential
514,609,37,4,3937.44,3,1,1,5,Promising
515,610,47,9,8135.950000000001,2,4,4,10,Highly potential
516,611,4,8,10622.380000000001,4,4,4,12,Highly potential
517,612,2,4,5011.469999999999,4,1,2,7,Require Activation
518,613,4,6,5898.85,4,3,3,10,Highly potential
519,615,43,4,6230.810000000001,3,1,3,7,Require Activation
520,617,21,4,3343.8599999999997,3,1,1,5,Promising
521,618,309,2,2207.71,1,1,1,3,Require Activation
522,619,66,7,7042.709999999999,2,3,3,8,Require Activation
523,620,104,8,5422.25,1,4,2,7,Require Activation
524,621,3,9,11872.47,4,4,4,12,Highly potential
525,623,94,3,5060.18,1,1,2,4,Needs Attention
526,624,91,3,5079.93,1,1,2,4,Needs Attention
527,625,17,6,5688.67,4,3,2,9,Highly potential
528,626,55,9,8102.3,2,4,4,10,Highly potential
529,628,55,5,5519.54,2,2,2,6,Loyal
530,629,65,8,6490.53,2,4,3,9,Highly potential
531,630,54,7,9406.55,2,3,4,9,Highly potential
532,631,17,6,3211.98,4,3,1,8,Require Activation
533,632,42,3,3911.85,3,1,1,5,Promising
534,633,2,7,7054.02,4,3,3,10,Highly potential
535,634,18,7,6314.14,4,3,3,10,Highly potential
536,635,40,6,3988.82,3,3,1,7,Require Activation
537,636,20,7,7808.710000000001,3,3,3,9,Highly potential
538,637,8,13,13899.73,4,4,4,12,Highly potential
539,639,9,6,5831.549999999999,4,3,2,9,Highly potential
540,640,11,8,11141.29,4,4,4,12,Highly potential
541,641,203,4,3853.3399999999997,1,1,1,3,Require Activation
542,642,25,7,5304.37,3,3,2,8,Require Activation
543,643,198,4,5034.78,1,1,2,4,Needs Attention
544,644,158,3,1808.74,1,1,1,3,Require Activation
545,645,117,7,9008.59,1,3,4,8,Require Activation
546,646,111,4,4809.5199999999995,1,1,2,4,Needs Attention
547,647,43,9,10703.609999999999,3,4,4,11,Highly potential
548,648,58,7,8410.929999999998,2,3,4,9,Highly potential
549,649,12,5,1718.19,4,2,1,7,Require Activation
550,650,51,6,7082.77,2,3,3,8,Require Activation
551,651,19,3,5028.17,4,1,2,7,Require Activation
552,652,6,9,10240.869999999999,4,4,4,12,Highly potential
553,653,38,5,4502.58,3,2,2,7,Require Activation
554,654,29,3,3391.62,3,1,1,5,Promising
555,655,52,6,8876.489999999998,2,3,4,9,Highly potential
556,656,11,8,8438.349999999999,4,4,4,12,Highly potential
557,658,98,5,5305.31,1,2,2,5,Promising
558,661,35,6,5564.07,3,3,2,8,Require Activation
559,662,87,7,6635.87,2,3,3,8,Require Activation
560,663,74,4,5447.210000000001,2,1,2,5,Promising
561,664,85,4,2941.31,2,1,1,4,Needs Attention
562,665,86,7,7378.3,2,3,3,8,Require Activation
563,666,42,5,5173.84,3,2,2,7,Require Activation
564,667,20,5,5826.33,3,2,2,7,Require Activation
565,668,7,7,7399.77,4,3,3,10,Highly potential
566,669,9,11,12187.94,4,4,4,12,Highly potential
567,670,117,4,4078.3999999999996,1,1,1,3,Require Activation
568,672,51,3,4786.219999999999,2,1,2,5,Promising
569,673,3,5,3435.2199999999993,4,2,1,7,Require Activation
570,674,116,6,6404.850000000001,1,3,3,7,Require Activation
571,675,1,3,4204.51,4,1,2,7,Require Activation
572,677,72,5,3703.870000000001,2,2,1,5,Promising
573,678,95,3,2079.27,1,1,1,3,Require Activation
574,679,63,10,8300.07,2,4,4,10,Highly potential
575,681,8,6,5888.740000000001,4,3,2,9,Highly potential
576,682,21,7,8280.35,3,3,4,10,Highly potential
577,686,38,5,4622.87,3,2,2,7,Require Activation
578,687,9,6,2828.68,4,3,1,8,Require Activation
579,688,82,4,5647.04,2,1,2,5,Promising
580,689,13,3,3614.25,4,1,1,6,Loyal
581,692,51,9,8189.469999999999,2,4,4,10,Highly potential
582,694,8,5,4359.78,4,2,2,8,Require Activation
583,695,17,8,10407.64,4,4,4,12,Highly potential
584,696,22,6,3720.1000000000004,3,3,1,7,Require Activation
585,697,12,4,5888.76,4,1,2,7,Require Activation
586,698,77,3,3362.66,2,1,1,4,Needs Attention
587,699,56,3,2655.81,2,1,1,4,Needs Attention
588,701,33,6,6285.290000000001,3,3,3,9,Highly potential
589,702,63,3,3825.66,2,1,1,4,Needs Attention
590,704,11,10,10881.810000000001,4,4,4,12,Highly potential
591,705,12,4,2127.8599999999997,4,1,1,6,Loyal
592,706,31,6,10040.499999999998,3,3,4,10,Highly potential
593,707,45,6,7563.61,3,3,3,9,Highly potential
594,708,176,3,3149.03,1,1,1,3,Require Activation
595,709,147,5,5948.8099999999995,1,2,3,6,Loyal
596,710,40,6,7830.880000000001,3,3,3,9,Highly potential
597,713,256,4,4564.42,1,1,2,4,Needs Attention
598,715,159,3,4278.66,1,1,2,4,Needs Attention
599,716,13,6,6680.780000000001,4,3,3,10,Highly potential
600,717,15,6,4696.910000000001,4,3,2,9,Highly potential
601,718,35,8,6777.429999999999,3,4,3,10,Highly potential
602,719,12,8,10796.76,4,4,4,12,Highly potential
603,720,21,10,13004.35,3,4,4,11,Highly potential
604,721,5,7,8883.609999999999,4,3,4,11,Highly potential
605,722,88,5,6548.610000000001,2,2,3,7,Require Activation
606,723,16,8,7012.59,4,4,3,11,Highly potential
607,724,24,8,9812.699999999999,3,4,4,11,Highly potential
608,725,4,11,13048.82,4,4,4,12,Highly potential
609,726,55,3,5134.71,2,1,2,5,Promising
610,727,62,6,8768.09,2,3,4,9,Highly potential
611,728,26,9,10919.45,3,4,4,11,Highly potential
612,729,2,9,14032.57,4,4,4,12,Highly potential
613,730,15,7,6529.49,4,3,3,10,Highly potential
614,732,65,5,6099.15,2,2,3,7,Require Activation
615,734,90,3,3346.12,1,1,1,3,Require Activation
616,735,88,4,6814.03,2,1,3,6,Loyal
617,736,12,5,5823.83,4,2,2,8,Require Activation
618,737,55,7,7386.14,2,3,3,8,Require Activation
619,739,2,10,9430.630000000001,4,4,4,12,Highly potential
620,742,11,6,6918.959999999999,4,3,3,10,Highly potential
621,743,90,4,4994.21,1,1,2,4,Needs Attention
622,746,44,6,4853.96,3,3,2,8,Require Activation
623,747,36,2,1801.98,3,1,1,5,Promising
624,748,47,9,8538.05,2,4,4,10,Highly potential
625,749,81,9,7591.94,2,4,3,9,Highly potential
626,750,59,6,7506.7300000000005,2,3,3,8,Require Activation
627,751,131,2,386.48,1,1,1,3,Require Activation
628,752,21,8,8004.32,3,4,3,10,Highly potential
629,753,16,8,11935.38,4,4,4,12,Highly potential
630,754,211,2,814.03,1,1,1,3,Require Activation
631,755,96,3,2071.78,1,1,1,3,Require Activation
632,756,26,6,3859.1699999999996,3,3,1,7,Require Activation
633,757,73,5,3967.6,2,2,1,5,Promising
634,759,24,8,7442.61,3,4,3,10,Highly potential
635,760,27,9,8569.289999999999,3,4,4,11,Highly potential
636,761,146,5,6483.680000000001,1,2,3,6,Loyal
637,762,86,5,3989.6800000000003,2,2,1,5,Promising
638,763,75,6,6989.88,2,3,3,8,Require Activation
639,764,80,3,3627.46,2,1,1,4,Needs Attention
640,767,43,5,6197.59,3,2,3,8,Require Activation
641,768,6,9,9425.52,4,4,4,12,Highly potential
642,769,20,8,9694.79,3,4,4,11,Highly potential
643,770,50,6,6789.79,2,3,3,8,Require Activation
644,772,3,6,8421.58,4,3,4,11,Highly potential
645,774,144,1,1311.44,1,1,1,3,Require Activation
646,775,59,7,6985.21,2,3,3,8,Require Activation
647,776,14,9,9151.17,4,4,4,12,Highly potential
648,777,28,6,5113.99,3,3,2,8,Require Activation
649,778,264,3,2604.1800000000003,1,1,1,3,Require Activation
650,779,83,4,3079.5,2,1,1,4,Needs Attention
651,781,126,5,3763.46,1,2,1,4,Needs Attention
652,782,26,6,10216.48,3,3,4,10,Highly potential
653,783,97,5,6170.6,1,2,3,6,Loyal
654,784,144,2,760.18,1,1,1,3,Require Activation
655,785,19,6,4304.54,4,3,2,9,Highly potential
656,788,40,5,4638.62,3,2,2,7,Require Activation
657,789,5,8,4497.3,4,4,2,10,Highly potential
658,791,124,6,6605.22,1,3,3,7,Require Activation
659,792,18,6,6907.9000000000015,4,3,3,10,Highly potential
660,793,2,10,12116.109999999999,4,4,4,12,Highly potential
661,794,23,7,7832.739999999999,3,3,3,9,Highly potential
662,795,19,5,5980.89,4,2,3,9,Highly potential
663,796,7,7,6097.050000000001,4,3,3,10,Highly potential
664,797,22,4,4668.490000000001,3,1,2,6,Loyal
665,798,22,3,4285.05,3,1,2,6,Loyal
666,800,86,6,6283.9,2,3,3,8,Require Activation
667,801,183,2,1074.8,1,1,1,3,Require Activation
668,802,96,6,7508.74,1,3,3,7,Require Activation
669,803,67,6,3818.2500000000005,2,3,1,6,Loyal
670,804,42,3,3480.5,3,1,1,5,Promising
671,805,123,6,6966.17,1,3,3,7,Require Activation
672,806,32,4,4854.46,3,1,2,6,Loyal
673,807,81,4,4367.13,2,1,2,5,Promising
674,808,124,3,3676.8199999999997,1,1,1,3,Require Activation
675,809,46,4,3653.47,2,1,1,4,Needs Attention
676,810,69,4,4539.42,2,1,2,5,Promising
677,811,175,3,1388.0299999999997,1,1,1,3,Require Activation
678,813,51,5,4386.05,2,2,2,6,Loyal
679,814,49,3,4661.23,2,1,2,5,Promising
680,816,54,3,1548.1299999999999,2,1,1,4,Needs Attention
681,817,17,5,5340.0,4,2,2,8,Require Activation
682,818,41,6,6141.459999999999,3,3,3,9,Highly potential
683,819,44,5,5033.210000000001,3,2,2,7,Require Activation
684,821,34,5,4826.39,3,2,2,7,Require Activation
685,822,329,1,2005.66,1,1,1,3,Require Activation
686,823,24,6,9755.810000000001,3,3,4,10,Highly potential
687,824,10,4,6017.27,4,1,3,8,Require Activation
688,825,11,6,4476.59,4,3,2,9,Highly potential
689,826,5,4,4829.57,4,1,2,7,Require Activation
690,829,13,6,9236.19,4,3,4,11,Highly potential
691,830,150,6,6106.9400000000005,1,3,3,7,Require Activation
692,831,12,5,4245.84,4,2,2,8,Require Activation
693,832,18,11,12410.17,4,4,4,12,Highly potential
694,833,26,8,8852.31,3,4,4,11,Highly potential
695,834,19,4,3595.5299999999997,4,1,1,6,Loyal
696,835,8,8,8541.23,4,4,4,12,Highly potential
697,836,73,4,3562.2000000000003,2,1,1,4,Needs Attention
698,837,158,3,3406.25,1,1,1,3,Require Activation
699,838,42,4,3724.8199999999997,3,1,1,5,Promising
700,840,39,6,8144.96,3,3,4,10,Highly potential
701,841,151,7,10936.199999999999,1,3,4,8,Require Activation
702,842,56,3,2614.8,2,1,1,4,Needs Attention
703,843,3,6,4090.1900000000005,4,3,1,8,Require Activation
704,844,32,9,12523.550000000001,3,4,4,11,Highly potential
705,845,98,4,3639.4299999999994,1,1,1,3,Require Activation
706,846,83,3,4385.62,2,1,2,5,Promising
707,847,115,4,4928.17,1,1,2,4,Needs Attention
708,848,141,4,4711.04,1,1,2,4,Needs Attention
709,849,28,6,6086.660000000001,3,3,3,9,Highly potential
710,850,35,8,7476.789999999999,3,4,3,10,Highly potential
711,851,10,4,5346.999999999999,4,1,2,7,Require Activation
712,853,65,9,12711.369999999997,2,4,4,10,Highly potential
713,854,9,4,3992.51,4,1,1,6,Loyal
714,855,105,4,7241.66,1,1,3,5,Promising
715,856,2,7,6845.040000000001,4,3,3,10,Highly potential
716,858,12,6,5654.55,4,3,2,9,Highly potential
717,859,19,6,6979.780000000001,4,3,3,10,Highly potential
718,861,55,5,5226.41,2,2,2,6,Loyal
719,862,55,1,774.53,2,1,1,4,Needs Attention
720,863,70,4,2288.23,2,1,1,4,Needs Attention
721,865,122,7,7192.900000000001,1,3,3,7,Require Activation
722,866,99,5,7599.92,1,2,3,6,Loyal
723,867,294,5,6543.92,1,2,3,6,Loyal
724,868,84,6,7529.64,2,3,3,8,Require Activation
725,870,101,7,6201.42,1,3,3,7,Require Activation
726,872,172,1,290.62,1,1,1,3,Require Activation
727,873,32,5,4426.2,3,2,2,7,Require Activation
728,875,64,6,6933.689999999999,2,3,3,8,Require Activation
729,876,17,3,2732.4700000000003,4,1,1,6,Loyal
730,877,18,9,9182.89,4,4,4,12,Highly potential
731,878,80,3,4531.79,2,1,2,5,Promising
732,880,63,3,4774.51,2,1,2,5,Promising
733,881,148,3,5353.860000000001,1,1,2,4,Needs Attention
734,884,2,5,9210.74,4,2,4,10,Highly potential
735,885,8,3,3628.94,4,1,1,6,Loyal
736,886,2,7,9025.03,4,3,4,11,Highly potential
737,888,69,5,5750.620000000001,2,2,2,6,Loyal
738,889,37,5,4366.950000000001,3,2,2,7,Require Activation
739,890,166,4,4485.6,1,1,2,4,Needs Attention
740,891,13,5,6442.05,4,2,3,9,Highly potential
741,893,76,7,9202.85,2,3,4,9,Highly potential
742,894,49,8,7512.4800000000005,2,4,3,9,Highly potential
743,896,39,4,4448.32,3,1,2,6,Loyal
744,897,130,6,7311.98,1,3,3,7,Require Activation
745,898,206,1,478.16,1,1,1,3,Require Activation
746,899,50,6,4240.0599999999995,2,3,2,7,Require Activation
747,900,13,4,2446.4399999999996,4,1,1,6,Loyal
748,902,15,9,9408.529999999999,4,4,4,12,Highly potential
749,904,38,4,5063.82,3,1,2,6,Loyal
750,905,106,8,6801.49,1,4,3,8,Require Activation
751,906,17,9,12920.29,4,4,4,12,Highly potential
752,907,27,7,3448.8699999999994,3,3,1,7,Require Activation
753,909,190,5,8560.51,1,2,4,7,Require Activation
754,910,273,2,1932.55,1,1,1,3,Require Activation
755,911,57,5,3792.6,2,2,1,5,Promising
756,912,41,7,7206.5199999999995,3,3,3,9,Highly potential
757,914,107,5,5533.82,1,2,2,5,Promising
758,915,29,5,4802.6,3,2,2,7,Require Activation
759,917,36,8,7452.88,3,4,3,10,Highly potential
760,918,17,5,5684.7,4,2,2,8,Require Activation
761,919,81,9,10701.039999999999,2,4,4,10,Highly potential
762,920,91,6,6259.75,1,3,3,7,Require Activation
763,921,45,7,10039.390000000001,3,3,4,10,Highly potential
764,922,189,1,569.56,1,1,1,3,Require Activation
765,923,33,7,6019.1900000000005,3,3,3,9,Highly potential
766,924,110,8,7663.969999999999,1,4,3,8,Require Activation
767,925,13,9,10701.39,4,4,4,12,Highly potential
768,926,13,6,5627.58,4,3,2,9,Highly potential
769,928,12,8,6370.6900000000005,4,4,3,11,Highly potential
770,929,57,5,4985.79,2,2,2,6,Loyal
771,930,148,2,1431.17,1,1,1,3,Require Activation
772,931,71,5,6046.89,2,2,3,7,Require Activation
773,932,4,6,4854.48,4,3,2,9,Highly potential
774,933,1,5,7598.65,4,2,3,9,Highly potential
775,934,1,7,8420.859999999999,4,3,4,11,Highly potential
776,935,54,7,8652.220000000001,2,3,4,9,Highly potential
777,936,33,11,15702.070000000002,3,4,4,11,Highly potential
778,937,16,5,4550.33,4,2,2,8,Require Activation
779,939,32,4,5121.02,3,1,2,6,Loyal
780,940,53,5,6172.42,2,2,3,7,Require Activation
781,941,34,10,17898.46,3,4,4,11,Highly potential
782,942,214,2,2265.36,1,1,1,3,Require Activation
783,943,113,6,7886.52,1,3,3,7,Require Activation
784,945,15,7,9247.25,4,3,4,11,Highly potential
785,946,3,8,10866.75,4,4,4,12,Highly potential
786,947,81,5,5493.35,2,2,2,6,Loyal
787,948,101,3,3541.5999999999995,1,1,1,3,Require Activation
788,949,89,6,6945.27,2,3,3,8,Require Activation
789,951,7,6,4934.83,4,3,2,9,Highly potential
790,952,47,5,6239.169999999999,2,2,3,7,Require Activation
791,954,114,4,5686.31,1,1,2,4,Needs Attention
792,955,14,7,3915.94,4,3,1,8,Require Activation
793,956,174,3,3675.74,1,1,1,3,Require Activation
794,957,39,5,4868.3,3,2,2,7,Require Activation
795,958,35,6,5470.13,3,3,2,8,Require Activation
796,959,77,6,5701.849999999999,2,3,2,7,Require Activation
797,960,79,4,5971.35,2,1,3,6,Loyal
798,961,65,3,3792.14,2,1,1,4,Needs Attention
799,962,3,7,5930.27,4,3,3,10,Highly potential
800,963,61,12,12068.12,2,4,4,10,Highly potential
801,964,2,5,4224.59,4,2,2,8,Require Activation
802,965,61,4,5232.650000000001,2,1,2,5,Promising
803,966,14,4,1885.6100000000001,4,1,1,6,Loyal
804,967,67,4,5974.77,2,1,3,6,Loyal
805,968,36,6,7331.34,3,3,3,9,Highly potential
806,969,18,5,6968.38,4,2,3,9,Highly potential
807,970,34,5,6237.67,3,2,3,8,Require Activation
808,971,49,5,5862.57,2,2,2,6,Loyal
809,972,176,2,3318.8099999999995,1,1,1,3,Require Activation
810,973,9,8,12724.26,4,4,4,12,Highly potential
811,974,7,6,6929.71,4,3,3,10,Highly potential
812,976,171,6,6710.56,1,3,3,7,Require Activation
813,977,42,5,5149.34,3,2,2,7,Require Activation
814,978,193,5,4373.97,1,2,2,5,Promising
815,979,6,5,7486.820000000001,4,2,3,9,Highly potential
816,980,178,4,5656.34,1,1,2,4,Needs Attention
817,982,56,6,2794.75,2,3,1,6,Loyal
818,984,57,8,6208.719999999999,2,4,3,9,Highly potential
819,985,15,4,5554.1900000000005,4,1,2,7,Require Activation
820,986,76,8,8673.32,2,4,4,10,Highly potential
821,987,23,8,8979.65,3,4,4,11,Highly potential
822,988,113,2,769.14,1,1,1,3,Require Activation
823,989,26,4,5497.839999999999,3,1,2,6,Loyal
824,990,12,7,8441.6,4,3,4,11,Highly potential
825,991,148,6,7774.3,1,3,3,7,Require Activation
826,993,1,9,8086.79,4,4,4,12,Highly potential
827,994,43,5,3901.01,3,2,1,6,Loyal
828,995,12,7,9379.04,4,3,4,11,Highly potential
829,997,60,7,6397.73,2,3,3,8,Require Activation
830,998,322,2,1565.5500000000002,1,1,1,3,Require Activation
831,999,77,9,14166.419999999998,2,4,4,10,Highly potential
832,1000,1,9,10183.7,4,4,4,12,Highly potential
833,1001,43,7,6233.509999999999,3,3,3,9,Highly potential
834,1002,156,4,5038.32,1,1,2,4,Needs Attention
835,1003,48,9,9111.19,2,4,4,10,Highly potential
836,1004,204,6,8437.869999999999,1,3,4,8,Require Activation
837,1005,160,5,7863.759999999999,1,2,3,6,Loyal
838,1006,38,8,9481.25,3,4,4,11,Highly potential
839,1008,18,4,5409.6900000000005,4,1,2,7,Require Activation
840,1009,55,4,5716.2,2,1,2,5,Promising
841,1010,127,3,1501.59,1,1,1,3,Require Activation
842,1011,243,3,3940.1800000000003,1,1,1,3,Require Activation
843,1012,10,4,5094.62,4,1,2,7,Require Activation
844,1013,96,6,7207.57,1,3,3,7,Require Activation
845,1014,5,7,6269.75,4,3,3,10,Highly potential
846,1015,27,6,7096.789999999999,3,3,3,9,Highly potential
847,1016,67,6,5697.799999999999,2,3,2,7,Require Activation
848,1017,227,3,5234.68,1,1,2,4,Needs Attention
849,1018,27,5,6164.88,3,2,3,8,Require Activation
850,1019,43,5,5805.35,3,2,2,7,Require Activation
851,1021,29,8,9624.449999999999,3,4,4,11,Highly potential
852,1022,84,5,8161.4,2,2,4,8,Require Activation
853,1024,35,8,9592.03,3,4,4,11,Highly potential
854,1025,61,8,8141.290000000001,2,4,4,10,Highly potential
855,1027,25,6,6580.15,3,3,3,9,Highly potential
856,1028,9,7,12001.41,4,3,4,11,Highly potential
857,1029,31,6,6223.08,3,3,3,9,Highly potential
858,1030,40,8,10951.8,3,4,4,11,Highly potential
859,1031,47,3,2352.9300000000003,2,1,1,4,Needs Attention
860,1032,31,8,6902.839999999999,3,4,3,10,Highly potential
861,1035,14,3,1327.0600000000002,4,1,1,6,Loyal
862,1036,163,5,7125.260000000001,1,2,3,6,Loyal
863,1037,74,8,6925.18,2,4,3,9,Highly potential
864,1040,162,4,4072.6499999999996,1,1,1,3,Require Activation
865,1042,36,3,4585.77,3,1,2,6,Loyal
866,1043,155,8,10994.24,1,4,4,9,Highly potential
867,1046,53,5,3846.1,2,2,1,5,Promising
868,1047,58,7,5171.35,2,3,2,7,Require Activation
869,1048,134,7,6677.74,1,3,3,7,Require Activation
870,1049,33,10,11130.050000000001,3,4,4,11,Highly potential
871,1050,27,6,4722.12,3,3,2,8,Require Activation
872,1051,180,5,4878.81,1,2,2,5,Promising
873,1052,1,6,8478.41,4,3,4,11,Highly potential
874,1054,6,8,8433.75,4,4,4,12,Highly potential
875,1055,207,2,924.06,1,1,1,3,Require Activation
876,1056,25,7,7920.27,3,3,3,9,Highly potential
877,1057,113,3,4028.4700000000003,1,1,1,3,Require Activation
878,1058,117,3,2308.7200000000003,1,1,1,3,Require Activation
879,1059,23,2,2449.81,3,1,1,5,Promising
880,1060,188,6,9606.77,1,3,4,8,Require Activation
881,1062,3,6,7619.47,4,3,3,10,Highly potential
882,1063,47,6,5833.22,2,3,2,7,Require Activation
883,1064,140,3,5404.67,1,1,2,4,Needs Attention
884,1065,80,6,4709.66,2,3,2,7,Require Activation
885,1066,167,3,2637.5299999999997,1,1,1,3,Require Activation
886,1067,233,2,1854.93,1,1,1,3,Require Activation
887,1069,205,5,6910.5,1,2,3,6,Loyal
888,1070,1,4,5754.660000000001,4,1,2,7,Require Activation
889,1072,47,3,3697.58,2,1,1,4,Needs Attention
890,1073,18,6,6454.89,4,3,3,10,Highly potential
891,1074,17,8,9370.01,4,4,4,12,Highly potential
892,1075,68,6,6597.82,2,3,3,8,Require Activation
893,1076,10,12,14390.1,4,4,4,12,Highly potential
894,1078,19,5,3640.22,4,2,1,7,Require Activation
895,1079,18,4,3829.1099999999997,4,1,1,6,Loyal
896,1080,48,3,3133.43,2,1,1,4,Needs Attention
897,1081,12,5,6119.719999999999,4,2,3,9,Highly potential
898,1083,267,2,2418.19,1,1,1,3,Require Activation
899,1084,5,11,11437.05,4,4,4,12,Highly potential
900,1085,65,4,2487.7000000000003,2,1,1,4,Needs Attention
901,1086,14,9,8640.220000000001,4,4,4,12,Highly potential
902,1087,15,3,3535.79,4,1,1,6,Loyal
903,1088,14,6,6230.39,4,3,3,10,Highly potential
904,1089,152,7,6202.849999999999,1,3,3,7,Require Activation
905,1092,203,5,4893.72,1,2,2,5,Promising
906,1093,100,9,12492.4,1,4,4,9,Highly potential
907,1094,44,7,7255.12,3,3,3,9,Highly potential
908,1095,15,4,6916.039999999999,4,1,3,8,Require Activation
909,1096,56,5,3865.37,2,2,1,5,Promising
910,1097,189,3,2378.51,1,1,1,3,Require Activation
911,1098,9,8,7594.290000000001,4,4,3,11,Highly potential
912,1099,111,2,1248.96,1,1,1,3,Require Activation
913,1100,46,3,2767.35,2,1,1,4,Needs Attention
914,1101,114,5,6377.620000000001,1,2,3,6,Loyal
915,1102,22,8,8832.98,3,4,4,11,Highly potential
916,1103,33,12,15447.920000000002,3,4,4,11,Highly potential
917,1104,12,7,6458.3,4,3,3,10,Highly potential
918,1105,17,2,3965.4399999999996,4,1,1,6,Loyal
919,1106,25,9,11078.47,3,4,4,11,Highly potential
920,1107,49,5,3752.08,2,2,1,5,Promising
921,1108,13,4,1790.0,4,1,1,6,Loyal
922,1109,209,3,2411.02,1,1,1,3,Require Activation
923,1110,18,6,7310.360000000001,4,3,3,10,Highly potential
924,1111,21,7,6922.7,3,3,3,9,Highly potential
925,1113,27,9,10999.369999999999,3,4,4,11,Highly potential
926,1114,65,4,4156.4,2,1,2,5,Promising
927,1115,3,9,9270.03,4,4,4,12,Highly potential
928,1116,8,3,4932.34,4,1,2,7,Require Activation
929,1117,137,10,8604.73,1,4,4,9,Highly potential
930,1118,39,4,3365.1899999999996,3,1,1,5,Promising
931,1120,2,5,3916.82,4,2,1,7,Require Activation
932,1121,8,2,2973.36,4,1,1,6,Loyal
933,1124,45,3,3731.08,3,1,1,5,Promising
934,1125,30,5,3793.5699999999997,3,2,1,6,Loyal
935,1126,20,4,4725.4400000000005,3,1,2,6,Loyal
936,1127,137,4,5261.43,1,1,2,4,Needs Attention
937,1128,27,5,5855.4400000000005,3,2,2,7,Require Activation
938,1130,118,5,6301.280000000001,1,2,3,6,Loyal
939,1131,54,7,9150.94,2,3,4,9,Highly potential
940,1132,45,8,9603.1,3,4,4,11,Highly potential
941,1134,4,7,6797.389999999999,4,3,3,10,Highly potential
942,1135,165,3,3530.65,1,1,1,3,Require Activation
943,1136,36,5,5369.95,3,2,2,7,Require Activation
944,1137,6,9,8092.310000000001,4,4,4,12,Highly potential
945,1138,125,6,7506.16,1,3,3,7,Require Activation
946,1139,70,4,3684.36,2,1,1,4,Needs Attention
947,1140,7,11,12657.130000000001,4,4,4,12,Highly potential
948,1142,39,4,4828.389999999999,3,1,2,6,Loyal
949,1143,5,5,7112.88,4,2,3,9,Highly potential
950,1144,18,7,9425.65,4,3,4,11,Highly potential
951,1146,74,2,2213.67,2,1,1,4,Needs Attention
952,1147,166,6,8766.87,1,3,4,8,Require Activation
953,1148,9,3,3426.09,4,1,1,6,Loyal
954,1149,189,4,5793.360000000001,1,1,2,4,Needs Attention
955,1150,104,5,8439.82,1,2,4,7,Require Activation
956,1151,76,5,5819.58,2,2,2,6,Loyal
957,1152,25,8,9434.77,3,4,4,11,Highly potential
958,1153,18,5,3306.2400000000002,4,2,1,7,Require Activation
959,1154,132,6,3442.7799999999997,1,3,1,5,Promising
960,1155,30,7,5342.129999999999,3,3,2,8,Require Activation
961,1156,41,4,5965.44,3,1,3,7,Require Activation
962,1157,86,7,7726.53,2,3,3,8,Require Activation
963,1158,3,7,9091.98,4,3,4,11,Highly potential
964,1159,7,4,5803.34,4,1,2,7,Require Activation
965,1160,164,3,3192.0099999999998,1,1,1,3,Require Activation
966,1161,13,4,4151.98,4,1,2,7,Require Activation
967,1162,137,4,5369.27,1,1,2,4,Needs Attention
968,1163,49,5,2853.67,2,2,1,5,Promising
969,1164,154,3,2164.22,1,1,1,3,Require Activation
970,1165,11,9,6796.879999999999,4,4,3,11,Highly potential
971,1166,15,6,7638.8,4,3,3,10,Highly potential
972,1167,11,4,4106.64,4,1,1,6,Loyal
973,1168,60,7,10263.160000000002,2,3,4,9,Highly potential
974,1169,63,7,7605.57,2,3,3,8,Require Activation
975,1170,87,5,6345.1,2,2,3,7,Require Activation
976,1171,35,9,9811.45,3,4,4,11,Highly potential
977,1172,45,5,6054.04,3,2,3,8,Require Activation
978,1173,109,3,2042.9699999999998,1,1,1,3,Require Activation
979,1175,219,2,2449.24,1,1,1,3,Require Activation
980,1176,78,4,3909.54,2,1,1,4,Needs Attention
981,1177,88,8,8367.47,2,4,4,10,Highly potential
982,1178,45,8,10226.15,3,4,4,11,Highly potential
983,1179,8,4,6441.950000000001,4,1,3,8,Require Activation
984,1180,60,4,3870.83,2,1,1,4,Needs Attention
985,1181,45,10,9928.329999999998,3,4,4,11,Highly potential
986,1182,6,6,6422.9400000000005,4,3,3,10,Highly potential
987,1183,154,5,7060.07,1,2,3,6,Loyal
988,1184,6,6,7155.030000000001,4,3,3,10,Highly potential
989,1185,10,3,1957.1499999999999,4,1,1,6,Loyal
990,1186,34,6,5299.349999999999,3,3,2,8,Require Activation
991,1188,19,2,3043.9,4,1,1,6,Loyal
992,1189,48,4,2894.1,2,1,1,4,Needs Attention
993,1190,7,6,4050.1299999999997,4,3,1,8,Require Activation
994,1191,44,8,6925.330000000001,3,4,3,10,Highly potential
995,1192,80,5,4306.09,2,2,2,6,Loyal
996,1193,37,4,4694.620000000001,3,1,2,6,Loyal
997,1194,29,8,7829.330000000001,3,4,3,10,Highly potential
998,1195,20,5,5178.38,3,2,2,7,Require Activation
999,1196,19,6,5307.82,4,3,2,9,Highly potential
1000,1197,8,4,4455.89,4,1,2,7,Require Activation
1001,1198,69,6,6397.58,2,3,3,8,Require Activation
1002,1199,44,8,6090.450000000001,3,4,3,10,Highly potential
1003,1200,80,8,5923.110000000001,2,4,3,9,Highly potential
1004,1203,8,1,1036.59,4,1,1,6,Loyal
1005,1204,201,1,235.63,1,1,1,3,Require Activation
1006,1205,23,7,9339.339999999998,3,3,4,10,Highly potential
1007,1206,84,2,3229.76,2,1,1,4,Needs Attention
1008,1207,14,6,4027.6,4,3,1,8,Require Activation
1009,1208,78,5,6789.07,2,2,3,7,Require Activation
1010,1209,132,2,2368.55,1,1,1,3,Require Activation
1011,1211,235,4,2677.25,1,1,1,3,Require Activation
1012,1212,72,3,3843.34,2,1,1,4,Needs Attention
1013,1213,70,7,8448.45,2,3,4,9,Highly potential
1014,1214,24,4,4251.7,3,1,2,6,Loyal
1015,1215,78,8,7611.599999999999,2,4,3,9,Highly potential
1016,1216,8,4,3354.53,4,1,1,6,Loyal
1017,1217,11,7,8001.53,4,3,3,10,Highly potential
1018,1220,67,5,5406.34,2,2,2,6,Loyal
1019,1221,10,7,5309.76,4,3,2,9,Highly potential
1020,1222,52,3,2947.0299999999997,2,1,1,4,Needs Attention
1021,1224,48,7,8166.93,2,3,4,9,Highly potential
1022,1225,59,4,5271.6,2,1,2,5,Promising
1023,1226,25,5,5188.65,3,2,2,7,Require Activation
1024,1227,62,12,9340.669999999998,2,4,4,10,Highly potential
1025,1228,133,4,3561.17,1,1,1,3,Require Activation
1026,1229,20,9,6854.87,3,4,3,10,Highly potential
1027,1231,176,2,2000.5500000000002,1,1,1,3,Require Activation
1028,1232,5,9,10746.19,4,4,4,12,Highly potential
1029,1234,86,7,6365.5599999999995,2,3,3,8,Require Activation
1030,1235,82,3,4340.25,2,1,2,5,Promising
1031,1236,42,5,5581.900000000001,3,2,2,7,Require Activation
1032,1237,24,10,12299.65,3,4,4,11,Highly potential
1033,1238,102,4,1827.7399999999998,1,1,1,3,Require Activation
1034,1240,6,4,4634.82,4,1,2,7,Require Activation
1035,1241,76,7,7065.74,2,3,3,8,Require Activation
1036,1242,18,2,2610.13,4,1,1,6,Loyal
1037,1243,71,10,11625.08,2,4,4,10,Highly potential
1038,1245,72,7,5886.29,2,3,2,7,Require Activation
1039,1247,91,4,5835.85,1,1,2,4,Needs Attention
1040,1248,68,1,1661.92,2,1,1,4,Needs Attention
1041,1250,36,10,9534.190000000002,3,4,4,11,Highly potential
1042,1251,62,4,2360.34,2,1,1,4,Needs Attention
1043,1252,10,7,9665.09,4,3,4,11,Highly potential
1044,1254,38,7,6791.620000000001,3,3,3,9,Highly potential
1045,1256,82,6,6083.15,2,3,3,8,Require Activation
1046,1257,257,3,2708.91,1,1,1,3,Require Activation
1047,1258,53,8,8945.560000000001,2,4,4,10,Highly potential
1048,1259,42,7,8470.17,3,3,4,10,Highly potential
1049,1260,67,5,3845.9700000000003,2,2,1,5,Promising
1050,1261,49,6,4878.62,2,3,2,7,Require Activation
1051,1262,44,3,4584.04,3,1,2,6,Loyal
1052,1263,43,6,5354.29,3,3,2,8,Require Activation
1053,1265,8,4,4449.860000000001,4,1,2,7,Require Activation
1054,1267,142,4,6352.41,1,1,3,5,Promising
1055,1269,212,3,2962.88,1,1,1,3,Require Activation
1056,1270,206,4,3962.16,1,1,1,3,Require Activation
1057,1271,188,2,3387.5299999999997,1,1,1,3,Require Activation
1058,1273,24,3,3050.3100000000004,3,1,1,5,Promising
1059,1274,15,9,6912.7699999999995,4,4,3,11,Highly potential
1060,1275,150,6,5698.139999999999,1,3,2,6,Loyal
1061,1276,101,2,2585.3,1,1,1,3,Require Activation
1062,1277,56,3,2701.39,2,1,1,4,Needs Attention
1063,1278,65,4,6559.17,2,1,3,6,Loyal
1064,1279,53,6,6106.63,2,3,3,8,Require Activation
1065,1280,107,4,4802.049999999999,1,1,2,4,Needs Attention
1066,1281,88,3,3403.1799999999994,2,1,1,4,Needs Attention
1067,1282,39,8,10069.949999999999,3,4,4,11,Highly potential
1068,1283,94,2,2964.4,1,1,1,3,Require Activation
1069,1284,79,3,418.80999999999995,2,1,1,4,Needs Attention
1070,1285,119,7,10581.32,1,3,4,8,Require Activation
1071,1286,52,7,6400.92,2,3,3,8,Require Activation
1072,1287,68,7,9575.2,2,3,4,9,Highly potential
1073,1288,23,4,5733.47,3,1,2,6,Loyal
1074,1290,45,9,11890.970000000001,3,4,4,11,Highly potential
1075,1291,17,7,8651.92,4,3,4,11,Highly potential
1076,1293,240,5,5896.44,1,2,3,6,Loyal
1077,1295,30,6,5147.2300000000005,3,3,2,8,Require Activation
1078,1296,131,4,5977.84,1,1,3,5,Promising
1079,1297,3,6,6037.480000000001,4,3,3,10,Highly potential
1080,1298,142,5,7471.9800000000005,1,2,3,6,Loyal
1081,1299,7,7,9845.31,4,3,4,11,Highly potential
1082,1300,21,6,9217.349999999999,3,3,4,10,Highly potential
1083,1302,30,13,17035.829999999998,3,4,4,11,Highly potential
1084,1304,4,6,4316.4400000000005,4,3,2,9,Highly potential
1085,1305,143,5,4862.79,1,2,2,5,Promising
1086,1306,137,5,5037.3,1,2,2,5,Promising
1087,1307,91,9,9888.539999999999,1,4,4,9,Highly potential
1088,1308,16,5,7509.25,4,2,3,9,Highly potential
1089,1309,83,4,3547.4399999999996,2,1,1,4,Needs Attention
1090,1310,21,5,4177.02,3,2,2,7,Require Activation
1091,1311,48,3,4724.29,2,1,2,5,Promising
1092,1312,27,4,3066.41,3,1,1,5,Promising
1093,1313,8,7,8113.209999999999,4,3,4,11,Highly potential
1094,1314,28,5,5627.01,3,2,2,7,Require Activation
1095,1316,33,5,5704.709999999999,3,2,2,7,Require Activation
1096,1317,11,9,15370.809999999998,4,4,4,12,Highly potential
1097,1318,8,7,7834.26,4,3,3,10,Highly potential
1098,1321,104,7,5511.139999999999,1,3,2,6,Loyal
1099,1322,64,4,6024.349999999999,2,1,3,6,Loyal
1100,1323,54,7,3352.1499999999996,2,3,1,6,Loyal
1101,1324,75,7,6791.039999999999,2,3,3,8,Require Activation
1102,1325,83,1,416.98,2,1,1,4,Needs Attention
1103,1326,11,6,6384.11,4,3,3,10,Highly potential
1104,1327,7,5,5206.2699999999995,4,2,2,8,Require Activation
1105,1328,1,7,10301.23,4,3,4,11,Highly potential
1106,1329,5,11,14818.119999999999,4,4,4,12,Highly potential
1107,1330,76,6,8329.24,2,3,4,9,Highly potential
1108,1331,6,10,11641.260000000002,4,4,4,12,Highly potential
1109,1332,36,7,7755.360000000001,3,3,3,9,Highly potential
1110,1333,8,3,3501.8999999999996,4,1,1,6,Loyal
1111,1334,241,2,3129.3199999999997,1,1,1,3,Require Activation
1112,1336,79,6,6095.660000000001,2,3,3,8,Require Activation
1113,1337,84,6,6160.39,2,3,3,8,Require Activation
1114,1338,232,2,1671.8400000000001,1,1,1,3,Require Activation
1115,1339,103,5,6447.480000000001,1,2,3,6,Loyal
1116,1340,29,8,7371.420000000001,3,4,3,10,Highly potential
1117,1341,11,4,2841.0999999999995,4,1,1,6,Loyal
1118,1343,21,3,3737.6800000000003,3,1,1,5,Promising
1119,1344,22,3,1709.46,3,1,1,5,Promising
1120,1345,44,6,8121.72,3,3,4,10,Highly potential
1121,1346,16,9,10530.7,4,4,4,12,Highly potential
1122,1347,92,6,6106.51,1,3,3,7,Require Activation
1123,1348,115,5,7592.16,1,2,3,6,Loyal
1124,1349,44,6,4387.99,3,3,2,8,Require Activation
1125,1350,117,2,2243.46,1,1,1,3,Require Activation
1126,1352,89,3,2496.04,2,1,1,4,Needs Attention
1127,1353,15,8,6708.349999999999,4,4,3,11,Highly potential
1128,1354,75,3,3170.25,2,1,1,4,Needs Attention
1129,1355,9,5,5458.11,4,2,2,8,Require Activation
1130,1356,23,6,6474.389999999999,3,3,3,9,Highly potential
1131,1357,13,9,12232.580000000002,4,4,4,12,Highly potential
1132,1358,4,8,8559.16,4,4,4,12,Highly potential
1133,1359,13,2,2027.25,4,1,1,6,Loyal
1134,1360,182,3,3476.3199999999997,1,1,1,3,Require Activation
1135,1361,29,6,7203.26,3,3,3,9,Highly potential
1136,1362,119,2,2948.34,1,1,1,3,Require Activation
1137,1363,25,7,7017.55,3,3,3,9,Highly potential
1138,1364,65,4,3804.88,2,1,1,4,Needs Attention
1139,1365,218,4,2346.08,1,1,1,3,Require Activation
1140,1366,55,5,4035.1099999999997,2,2,1,5,Promising
1141,1367,12,7,4991.900000000001,4,3,2,9,Highly potential
1142,1369,179,4,4920.55,1,1,2,4,Needs Attention
1143,1370,27,4,3173.01,3,1,1,5,Promising
1144,1371,27,4,4146.6,3,1,2,6,Loyal
1145,1372,67,6,6444.009999999999,2,3,3,8,Require Activation
1146,1375,83,5,6008.950000000001,2,2,3,7,Require Activation
1147,1377,76,5,5783.17,2,2,2,6,Loyal
1148,1379,29,5,6509.42,3,2,3,8,Require Activation
1149,1380,199,3,4100.01,1,1,1,3,Require Activation
1150,1381,114,5,7293.990000000001,1,2,3,6,Loyal
1151,1382,123,2,2998.29,1,1,1,3,Require Activation
1152,1383,58,3,4082.21,2,1,1,4,Needs Attention
1153,1384,37,6,6268.25,3,3,3,9,Highly potential
1154,1385,143,5,7432.72,1,2,3,6,Loyal
1155,1386,107,3,3260.21,1,1,1,3,Require Activation
1156,1387,216,1,1635.3,1,1,1,3,Require Activation
1157,1388,20,6,6237.99,3,3,3,9,Highly potential
1158,1390,2,9,9070.85,4,4,4,12,Highly potential
1159,1391,64,3,3611.7799999999997,2,1,1,4,Needs Attention
1160,1392,108,3,4481.38,1,1,2,4,Needs Attention
1161,1395,88,2,2860.38,2,1,1,4,Needs Attention
1162,1396,10,10,11434.630000000001,4,4,4,12,Highly potential
1163,1397,138,6,7257.490000000001,1,3,3,7,Require Activation
1164,1398,37,7,8073.77,3,3,4,10,Highly potential
1165,1399,17,4,6034.2,4,1,3,8,Require Activation
1166,1400,57,7,9111.929999999998,2,3,4,9,Highly potential
1167,1402,41,8,7968.53,3,4,3,10,Highly potential
1168,1403,165,2,1663.42,1,1,1,3,Require Activation
1169,1404,8,10,9401.710000000001,4,4,4,12,Highly potential
1170,1405,34,11,7668.83,3,4,3,10,Highly potential
1171,1406,29,6,4605.349999999999,3,3,2,8,Require Activation
1172,1407,1,9,9199.51,4,4,4,12,Highly potential
1173,1408,11,3,4975.92,4,1,2,7,Require Activation
1174,1409,23,4,5869.549999999999,3,1,2,6,Loyal
1175,1410,61,7,10217.49,2,3,4,9,Highly potential
1176,1411,36,6,8273.8,3,3,4,10,Highly potential
1177,1412,122,4,3403.46,1,1,1,3,Require Activation
1178,1413,4,6,5581.840000000001,4,3,2,9,Highly potential
1179,1414,19,2,1758.44,4,1,1,6,Loyal
1180,1415,58,4,4962.58,2,1,2,5,Promising
1181,1416,115,4,3443.91,1,1,1,3,Require Activation
1182,1418,87,5,5545.360000000001,2,2,2,6,Loyal
1183,1419,23,5,3385.2400000000002,3,2,1,6,Loyal
1184,1420,39,5,4965.84,3,2,2,7,Require Activation
1185,1421,58,6,5452.030000000001,2,3,2,7,Require Activation
1186,1422,48,7,5995.74,2,3,3,8,Require Activation
1187,1423,25,6,7143.39,3,3,3,9,Highly potential
1188,1424,77,3,3560.7,2,1,1,4,Needs Attention
1189,1425,1,4,4470.96,4,1,2,7,Require Activation
1190,1426,49,7,5955.06,2,3,3,8,Require Activation
1191,1427,60,5,5854.77,2,2,2,6,Loyal
1192,1428,16,10,11559.729999999998,4,4,4,12,Highly potential
1193,1429,32,6,3862.7200000000003,3,3,1,7,Require Activation
1194,1430,109,5,4676.59,1,2,2,5,Promising
1195,1431,20,4,3180.4400000000005,3,1,1,5,Promising
1196,1432,34,6,5329.7300000000005,3,3,2,8,Require Activation
1197,1433,132,3,4030.1099999999997,1,1,1,3,Require Activation
1198,1434,125,2,2016.27,1,1,1,3,Require Activation
1199,1435,34,7,8853.71,3,3,4,10,Highly potential
1200,1436,73,5,5911.139999999999,2,2,3,7,Require Activation
1201,1437,144,3,3495.9300000000003,1,1,1,3,Require Activation
1202,1438,7,10,10627.41,4,4,4,12,Highly potential
1203,1439,66,3,3310.83,2,1,1,4,Needs Attention
1204,1440,20,6,8415.02,3,3,4,10,Highly potential
1205,1444,39,5,2497.07,3,2,1,6,Loyal
1206,1445,7,6,8482.71,4,3,4,11,Highly potential
1207,1446,11,7,9653.68,4,3,4,11,Highly potential
1208,1447,98,7,8905.63,1,3,4,8,Require Activation
1209,1448,238,1,642.31,1,1,1,3,Require Activation
1210,1449,15,6,8326.13,4,3,4,11,Highly potential
1211,1450,43,7,8942.800000000001,3,3,4,10,Highly potential
1212,1451,84,6,5516.52,2,3,2,7,Require Activation
1213,1452,3,5,5937.98,4,2,3,9,Highly potential
1214,1454,6,5,5619.66,4,2,2,8,Require Activation
1215,1456,9,4,1713.83,4,1,1,6,Loyal
1216,1457,66,6,6224.219999999999,2,3,3,8,Require Activation
1217,1458,199,3,4366.14,1,1,2,4,Needs Attention
1218,1459,99,4,5707.43,1,1,2,4,Needs Attention
1219,1460,13,8,14633.24,4,4,4,12,Highly potential
1220,1462,82,5,3667.87,2,2,1,5,Promising
1221,1463,111,5,5593.080000000001,1,2,2,5,Promising
1222,1464,107,6,4553.66,1,3,2,6,Loyal
1223,1465,108,4,3709.83,1,1,1,3,Require Activation
1224,1466,34,3,3383.13,3,1,1,5,Promising
1225,1468,110,6,7218.12,1,3,3,7,Require Activation
1226,1470,2,7,7379.8,4,3,3,10,Highly potential
1227,1472,70,7,8646.380000000001,2,3,4,9,Highly potential
1228,1473,33,11,11098.84,3,4,4,11,Highly potential
1229,1474,67,5,5061.36,2,2,2,6,Loyal
1230,1475,47,7,10929.81,2,3,4,9,Highly potential
1231,1476,25,2,2055.69,3,1,1,5,Promising
1232,1478,2,7,6907.849999999999,4,3,3,10,Highly potential
1233,1479,70,5,4646.92,2,2,2,6,Loyal
1234,1480,3,9,7182.38,4,4,3,11,Highly potential
1235,1481,21,8,7837.749999999999,3,4,3,10,Highly potential
1236,1482,69,12,14366.26,2,4,4,10,Highly potential
1237,1483,30,8,7979.169999999998,3,4,3,10,Highly potential
1238,1484,15,4,3395.0199999999995,4,1,1,6,Loyal
1239,1485,5,2,1871.67,4,1,1,6,Loyal
1240,1486,33,5,4895.26,3,2,2,7,Require Activation
1241,1487,18,2,617.38,4,1,1,6,Loyal
1242,1488,41,1,533.51,3,1,1,5,Promising
1243,1489,83,4,2348.25,2,1,1,4,Needs Attention
1244,1490,69,4,4593.42,2,1,2,5,Promising
1245,1491,161,3,3208.6000000000004,1,1,1,3,Require Activation
1246,1492,14,7,10034.769999999999,4,3,4,11,Highly potential
1247,1493,21,10,11653.87,3,4,4,11,Highly potential
1248,1494,19,10,11747.52,4,4,4,12,Highly potential
1249,1495,4,2,1217.97,4,1,1,6,Loyal
1250,1496,54,5,7189.5,2,2,3,7,Require Activation
1251,1497,183,6,6257.94,1,3,3,7,Require Activation
1252,1498,41,4,4031.87,3,1,1,5,Promising
1253,1499,126,5,5880.27,1,2,2,5,Promising
1254,1501,54,5,4317.1,2,2,2,6,Loyal
1255,1502,27,9,11571.9,3,4,4,11,Highly potential
1256,1503,161,8,12553.88,1,4,4,9,Highly potential
1257,1504,6,5,5266.7,4,2,2,8,Require Activation
1258,1505,19,4,5210.83,4,1,2,7,Require Activation
1259,1508,62,5,5437.079999999999,2,2,2,6,Loyal
1260,1510,57,2,2588.77,2,1,1,4,Needs Attention
1261,1511,17,8,7012.24,4,4,3,11,Highly potential
1262,1513,121,6,5632.320000000001,1,3,2,6,Loyal
1263,1514,68,7,7863.42,2,3,3,8,Require Activation
1264,1515,9,7,5844.51,4,3,2,9,Highly potential
1265,1516,38,5,5692.96,3,2,2,7,Require Activation
1266,1517,29,11,13750.08,3,4,4,11,Highly potential
1267,1518,92,4,4780.57,1,1,2,4,Needs Attention
1268,1519,9,11,9090.05,4,4,4,12,Highly potential
1269,1521,96,2,2287.37,1,1,1,3,Require Activation
1270,1522,10,5,5030.57,4,2,2,8,Require Activation
1271,1523,42,3,3736.42,3,1,1,5,Promising
1272,1524,38,8,5784.920000000001,3,4,2,9,Highly potential
1273,1525,25,3,2983.65,3,1,1,5,Promising
1274,1526,112,5,7076.290000000001,1,2,3,6,Loyal
1275,1527,42,8,8695.82,3,4,4,11,Highly potential
1276,1529,105,1,1810.0,1,1,1,3,Require Activation
1277,1530,2,10,13634.73,4,4,4,12,Highly potential
1278,1531,43,7,7667.54,3,3,3,9,Highly potential
1279,1532,4,6,6446.1900000000005,4,3,3,10,Highly potential
1280,1533,105,8,7532.76,1,4,3,8,Require Activation
1281,1534,47,7,7048.710000000001,2,3,3,8,Require Activation
1282,1535,105,5,7008.06,1,2,3,6,Loyal
1283,1536,34,4,4914.46,3,1,2,6,Loyal
1284,1537,27,9,9589.18,3,4,4,11,Highly potential
1285,1538,2,4,891.12,4,1,1,6,Loyal
1286,1539,66,8,6655.98,2,4,3,9,Highly potential
1287,1540,6,5,5874.45,4,2,2,8,Require Activation
1288,1541,71,5,6311.2,2,2,3,7,Require Activation
1289,1542,134,5,5625.49,1,2,2,5,Promising
1290,1543,75,3,2638.73,2,1,1,4,Needs Attention
1291,1544,330,1,1057.51,1,1,1,3,Require Activation
1292,1545,3,7,6179.73,4,3,3,10,Highly potential
1293,1546,70,6,6116.73,2,3,3,8,Require Activation
1294,1547,28,9,12870.899999999998,3,4,4,11,Highly potential
1295,1550,43,6,5181.85,3,3,2,8,Require Activation
1296,1551,23,7,7800.780000000001,3,3,3,9,Highly potential
1297,1552,100,5,6945.16,1,2,3,6,Loyal
1298,1553,85,4,4422.05,2,1,2,5,Promising
1299,1554,21,7,9898.230000000001,3,3,4,10,Highly potential
1300,1555,134,7,7885.780000000001,1,3,3,7,Require Activation
1301,1556,85,5,6248.450000000001,2,2,3,7,Require Activation
1302,1557,76,6,9663.51,2,3,4,9,Highly potential
1303,1558,9,9,13587.27,4,4,4,12,Highly potential
1304,1561,44,8,10601.55,3,4,4,11,Highly potential
1305,1562,101,3,4066.1100000000006,1,1,1,3,Require Activation
1306,1563,130,4,4845.110000000001,1,1,2,4,Needs Attention
1307,1564,14,3,2983.8,4,1,1,6,Loyal
1308,1565,10,2,3083.23,4,1,1,6,Loyal
1309,1566,87,4,2886.4399999999996,2,1,1,4,Needs Attention
1310,1567,25,7,10643.93,3,3,4,10,Highly potential
1311,1568,140,4,6373.65,1,1,3,5,Promising
1312,1569,54,1,1466.68,2,1,1,4,Needs Attention
1313,1570,34,9,9958.95,3,4,4,11,Highly potential
1314,1571,4,4,6221.7300000000005,4,1,3,8,Require Activation
1315,1572,83,6,10119.88,2,3,4,9,Highly potential
1316,1573,65,4,5400.4400000000005,2,1,2,5,Promising
1317,1574,74,10,9813.749999999998,2,4,4,10,Highly potential
1318,1575,87,4,4088.84,2,1,1,4,Needs Attention
1319,1576,38,7,7829.950000000001,3,3,3,9,Highly potential
1320,1577,13,7,7980.92,4,3,3,10,Highly potential
1321,1579,41,10,12087.02,3,4,4,11,Highly potential
1322,1580,56,8,7454.8099999999995,2,4,3,9,Highly potential
1323,1581,37,8,7922.66,3,4,3,10,Highly potential
1324,1582,56,5,5202.889999999999,2,2,2,6,Loyal
1325,1585,38,8,8002.97,3,4,3,10,Highly potential
1326,1586,17,6,6104.44,4,3,3,10,Highly potential
1327,1587,78,5,4992.59,2,2,2,6,Loyal
1328,1588,33,7,9131.539999999999,3,3,4,10,Highly potential
1329,1589,12,6,8549.57,4,3,4,11,Highly potential
1330,1590,87,3,5130.389999999999,2,1,2,5,Promising
1331,1591,30,11,12687.66,3,4,4,11,Highly potential
1332,1592,101,4,5703.38,1,1,2,4,Needs Attention
1333,1593,54,6,7569.45,2,3,3,8,Require Activation
1334,1594,1,6,8475.63,4,3,4,11,Highly potential
1335,1595,78,7,9792.890000000001,2,3,4,9,Highly potential
1336,1596,136,3,4400.92,1,1,2,4,Needs Attention
1337,1597,26,11,16245.230000000001,3,4,4,11,Highly potential
1338,1598,171,5,6297.23,1,2,3,6,Loyal
1339,1600,14,9,5904.3200000000015,4,4,3,11,Highly potential
1340,1601,20,4,3901.84,3,1,1,5,Promising
1341,1602,8,5,6779.29,4,2,3,9,Highly potential
1342,1603,24,4,5471.889999999999,3,1,2,6,Loyal
1343,1606,43,4,5390.66,3,1,2,6,Loyal
1344,1607,2,5,4898.71,4,2,2,8,Require Activation
1345,1608,13,3,2811.51,4,1,1,6,Loyal
1346,1609,62,5,6259.92,2,2,3,7,Require Activation
1347,1610,9,5,6734.610000000001,4,2,3,9,Highly potential
1348,1612,68,2,3904.22,2,1,1,4,Needs Attention
1349,1616,24,7,10413.51,3,3,4,10,Highly potential
1350,1617,6,5,5926.27,4,2,3,9,Highly potential
1351,1618,29,2,2033.21,3,1,1,5,Promising
1352,1619,85,10,11466.11,2,4,4,10,Highly potential
1353,1620,217,2,2947.04,1,1,1,3,Require Activation
1354,1621,83,5,2804.08,2,2,1,5,Promising
1355,1622,48,3,1952.29,2,1,1,4,Needs Attention
1356,1623,3,6,7686.06,4,3,3,10,Highly potential
1357,1624,4,6,4424.39,4,3,2,9,Highly potential
1358,1625,10,8,12809.369999999999,4,4,4,12,Highly potential
1359,1626,256,2,1789.3799999999999,1,1,1,3,Require Activation
1360,1627,25,8,10051.579999999998,3,4,4,11,Highly potential
1361,1629,2,7,8226.21,4,3,4,11,Highly potential
1362,1630,24,3,3699.7799999999997,3,1,1,5,Promising
1363,1631,132,4,4179.64,1,1,2,4,Needs Attention
1364,1632,282,1,1538.99,1,1,1,3,Require Activation
1365,1633,18,3,4623.68,4,1,2,7,Require Activation
1366,1634,30,4,3683.93,3,1,1,5,Promising
1367,1635,140,4,6745.709999999999,1,1,3,5,Promising
1368,1636,41,5,6065.61,3,2,3,8,Require Activation
1369,1637,144,7,7511.01,1,3,3,7,Require Activation
1370,1638,12,4,5237.9,4,1,2,7,Require Activation
1371,1640,63,7,5455.04,2,3,2,7,Require Activation
1372,1641,64,9,9474.24,2,4,4,10,Highly potential
1373,1642,85,5,4353.22,2,2,2,6,Loyal
1374,1644,23,7,8493.64,3,3,4,10,Highly potential
1375,1645,91,7,4521.05,1,3,2,6,Loyal
1376,1646,27,7,7426.27,3,3,3,9,Highly potential
1377,1648,14,4,4946.860000000001,4,1,2,7,Require Activation
1378,1649,72,3,4375.29,2,1,2,5,Promising
1379,1650,11,5,4358.9,4,2,2,8,Require Activation
1380,1652,97,6,7230.450000000001,1,3,3,7,Require Activation
1381,1654,85,4,4021.47,2,1,1,4,Needs Attention
1382,1655,17,3,3331.17,4,1,1,6,Loyal
1383,1656,85,6,6391.540000000001,2,3,3,8,Require Activation
1384,1657,62,5,5480.33,2,2,2,6,Loyal
1385,1658,281,4,3729.5499999999997,1,1,1,3,Require Activation
1386,1659,81,7,8004.330000000001,2,3,3,8,Require Activation
1387,1660,77,6,4480.62,2,3,2,7,Require Activation
1388,1661,219,6,8438.94,1,3,4,8,Require Activation
1389,1662,63,5,3125.38,2,2,1,5,Promising
1390,1663,14,6,8093.37,4,3,4,11,Highly potential
1391,1664,43,7,8460.32,3,3,4,10,Highly potential
1392,1665,69,7,6247.18,2,3,3,8,Require Activation
1393,1666,79,4,5256.49,2,1,2,5,Promising
1394,1667,77,7,9549.75,2,3,4,9,Highly potential
1395,1668,5,6,6878.43,4,3,3,10,Highly potential
1396,1669,60,6,6940.13,2,3,3,8,Require Activation
1397,1670,61,9,8855.960000000001,2,4,4,10,Highly potential
1398,1671,44,4,3197.84,3,1,1,5,Promising
1399,1672,43,11,11450.34,3,4,4,11,Highly potential
1400,1673,134,3,1318.28,1,1,1,3,Require Activation
1401,1674,49,5,1043.6999999999998,2,2,1,5,Promising
1402,1675,102,4,4572.34,1,1,2,4,Needs Attention
1403,1676,88,5,6881.579999999999,2,2,3,7,Require Activation
1404,1677,99,8,8188.1799999999985,1,4,4,9,Highly potential
1405,1679,137,4,5682.89,1,1,2,4,Needs Attention
1406,1680,113,3,5001.21,1,1,2,4,Needs Attention
1407,1682,83,6,10071.44,2,3,4,9,Highly potential
1408,1684,17,6,4309.7,4,3,2,9,Highly potential
1409,1685,26,2,1818.98,3,1,1,5,Promising
1410,1686,79,10,10098.74,2,4,4,10,Highly potential
1411,1688,24,8,8917.130000000001,3,4,4,11,Highly potential
1412,1689,137,5,7091.33,1,2,3,6,Loyal
1413,1690,17,9,8042.110000000001,4,4,4,12,Highly potential
1414,1692,128,4,1987.2,1,1,1,3,Require Activation
1415,1693,76,6,6723.21,2,3,3,8,Require Activation
1416,1695,38,5,7504.66,3,2,3,8,Require Activation
1417,1696,29,9,12254.53,3,4,4,11,Highly potential
1418,1697,25,5,6885.1500000000015,3,2,3,8,Require Activation
1419,1699,82,7,6876.639999999999,2,3,3,8,Require Activation
1420,1700,70,6,4957.01,2,3,2,7,Require Activation
1421,1702,15,6,5455.589999999999,4,3,2,9,Highly potential
1422,1703,4,4,2468.1899999999996,4,1,1,6,Loyal
1423,1704,120,2,3009.57,1,1,1,3,Require Activation
1424,1705,16,4,5029.5,4,1,2,7,Require Activation
1425,1707,18,8,6588.76,4,4,3,11,Highly potential
1426,1708,259,4,6112.640000000001,1,1,3,5,Promising
1427,1709,5,5,5390.71,4,2,2,8,Require Activation
1428,1710,81,4,4067.4900000000002,2,1,1,4,Needs Attention
1429,1713,7,7,9031.89,4,3,4,11,Highly potential
1430,1714,39,6,5717.15,3,3,2,8,Require Activation
1431,1715,103,3,2616.3199999999997,1,1,1,3,Require Activation
1432,1716,135,2,2372.87,1,1,1,3,Require Activation
1433,1717,47,4,3349.0299999999997,2,1,1,4,Needs Attention
1434,1718,25,5,4488.2,3,2,2,7,Require Activation
1435,1719,20,5,5061.53,3,2,2,7,Require Activation
1436,1720,24,5,5561.49,3,2,2,7,Require Activation
1437,1721,1,7,8195.2,4,3,4,11,Highly potential
1438,1722,5,8,10751.439999999999,4,4,4,12,Highly potential
1439,1723,18,5,4943.21,4,2,2,8,Require Activation
1440,1724,104,4,2074.23,1,1,1,3,Require Activation
1441,1725,61,7,10331.589999999998,2,3,4,9,Highly potential
1442,1726,118,6,8748.93,1,3,4,8,Require Activation
1443,1728,46,6,7811.599999999999,2,3,3,8,Require Activation
1444,1729,59,6,4397.5,2,3,2,7,Require Activation
1445,1730,21,3,3121.3,3,1,1,5,Promising
1446,1731,44,11,8015.92,3,4,3,10,Highly potential
1447,1732,98,5,4804.96,1,2,2,5,Promising
1448,1733,54,5,4933.33,2,2,2,6,Loyal
1449,1734,26,2,1998.5900000000001,3,1,1,5,Promising
1450,1735,66,4,4446.81,2,1,2,5,Promising
1451,1736,55,6,8725.86,2,3,4,9,Highly potential
1452,1737,46,3,4477.58,2,1,2,5,Promising
1453,1738,22,4,2808.24,3,1,1,5,Promising
1454,1739,38,4,4215.17,3,1,2,6,Loyal
1455,1741,65,3,4261.62,2,1,2,5,Promising
1456,1742,60,6,7168.48,2,3,3,8,Require Activation
1457,1743,87,7,8615.730000000001,2,3,4,9,Highly potential
1458,1744,110,3,1889.09,1,1,1,3,Require Activation
1459,1745,6,12,10025.74,4,4,4,12,Highly potential
1460,1747,191,4,2839.33,1,1,1,3,Require Activation
1461,1748,3,10,11012.260000000002,4,4,4,12,Highly potential
1462,1750,56,6,7768.64,2,3,3,8,Require Activation
1463,1752,29,7,5387.530000000001,3,3,2,8,Require Activation
1464,1753,28,4,4242.64,3,1,2,6,Loyal
1465,1755,49,6,6597.550000000001,2,3,3,8,Require Activation
1466,1758,3,7,4887.03,4,3,2,9,Highly potential
1467,1759,19,6,5494.57,4,3,2,9,Highly potential
1468,1760,13,6,6410.400000000001,4,3,3,10,Highly potential
1469,1761,19,5,5743.1,4,2,2,8,Require Activation
1470,1762,22,12,12375.52,3,4,4,11,Highly potential
1471,1763,10,7,7841.490000000001,4,3,3,10,Highly potential
1472,1764,3,4,3350.14,4,1,1,6,Loyal
1473,1765,47,6,8083.15,2,3,4,9,Highly potential
1474,1766,179,5,3464.7,1,2,1,4,Needs Attention
1475,1767,5,5,5973.14,4,2,3,9,Highly potential
1476,1768,93,1,945.04,1,1,1,3,Require Activation
1477,1770,14,7,8228.41,4,3,4,11,Highly potential
1478,1771,40,6,7019.950000000001,3,3,3,9,Highly potential
1479,1772,169,4,4467.889999999999,1,1,2,4,Needs Attention
1480,1774,98,4,3792.41,1,1,1,3,Require Activation
1481,1775,53,6,6171.379999999999,2,3,3,8,Require Activation
1482,1776,35,6,6401.14,3,3,3,9,Highly potential
1483,1777,71,6,6896.08,2,3,3,8,Require Activation
1484,1778,313,2,3040.4,1,1,1,3,Require Activation
1485,1779,130,6,8886.92,1,3,4,8,Require Activation
1486,1781,10,4,3282.1799999999994,4,1,1,6,Loyal
1487,1782,82,6,8490.84,2,3,4,9,Highly potential
1488,1784,72,4,4486.610000000001,2,1,2,5,Promising
1489,1785,35,6,5294.27,3,3,2,8,Require Activation
1490,1786,175,2,1570.1,1,1,1,3,Require Activation
1491,1787,1,6,7519.39,4,3,3,10,Highly potential
1492,1788,30,9,10584.150000000001,3,4,4,11,Highly potential
1493,1789,61,3,3728.3,2,1,1,4,Needs Attention
1494,1790,33,5,4313.98,3,2,2,7,Require Activation
1495,1791,118,6,7479.160000000001,1,3,3,7,Require Activation
1496,1793,61,6,7572.360000000001,2,3,3,8,Require Activation
1497,1794,2,4,3126.8999999999996,4,1,1,6,Loyal
1498,1795,4,6,6133.57,4,3,3,10,Highly potential
1499,1796,123,2,471.26,1,1,1,3,Require Activation
1500,1797,55,11,10502.990000000002,2,4,4,10,Highly potential
1501,1798,14,7,6605.389999999999,4,3,3,10,Highly potential
1502,1800,172,3,3565.92,1,1,1,3,Require Activation
1503,1801,66,8,9112.94,2,4,4,10,Highly potential
1504,1802,14,8,10435.94,4,4,4,12,Highly potential
1505,1804,32,3,4740.04,3,1,2,6,Loyal
1506,1805,91,4,2108.15,1,1,1,3,Require Activation
1507,1807,61,6,6829.25,2,3,3,8,Require Activation
1508,1808,77,7,10837.15,2,3,4,9,Highly potential
1509,1809,28,6,10150.57,3,3,4,10,Highly potential
1510,1810,7,2,458.74,4,1,1,6,Loyal
1511,1812,23,9,10214.4,3,4,4,11,Highly potential
1512,1813,19,6,6307.179999999999,4,3,3,10,Highly potential
1513,1814,52,6,4848.030000000001,2,3,2,7,Require Activation
1514,1815,12,5,4235.58,4,2,2,8,Require Activation
1515,1817,32,11,10054.070000000002,3,4,4,11,Highly potential
1516,1818,25,7,8942.78,3,3,4,10,Highly potential
1517,1819,253,2,2884.59,1,1,1,3,Require Activation
1518,1820,36,9,8429.29,3,4,4,11,Highly potential
1519,1821,25,12,14387.589999999998,3,4,4,11,Highly potential
1520,1823,162,6,6635.66,1,3,3,7,Require Activation
1521,1824,13,7,7059.410000000001,4,3,3,10,Highly potential
1522,1825,41,6,6976.92,3,3,3,9,Highly potential
1523,1826,41,7,6983.06,3,3,3,9,Highly potential
1524,1827,39,4,5169.16,3,1,2,6,Loyal
1525,1828,151,3,2146.84,1,1,1,3,Require Activation
1526,1829,4,3,2868.37,4,1,1,6,Loyal
1527,1830,14,7,7237.05,4,3,3,10,Highly potential
1528,1831,166,8,6774.879999999999,1,4,3,8,Require Activation
1529,1832,85,8,9260.84,2,4,4,10,Highly potential
1530,1833,11,5,4197.33,4,2,2,8,Require Activation
1531,1834,127,4,6290.79,1,1,3,5,Promising
1532,1835,26,6,5273.87,3,3,2,8,Require Activation
1533,1836,167,2,2832.71,1,1,1,3,Require Activation
1534,1837,36,7,9763.42,3,3,4,10,Highly potential
1535,1838,50,5,7121.110000000001,2,2,3,7,Require Activation
1536,1839,50,7,5930.82,2,3,3,8,Require Activation
1537,1840,99,7,6929.78,1,3,3,7,Require Activation
1538,1841,37,3,4263.92,3,1,2,6,Loyal
1539,1842,212,5,6542.54,1,2,3,6,Loyal
1540,1843,113,4,5065.639999999999,1,1,2,4,Needs Attention
1541,1844,42,7,9198.96,3,3,4,10,Highly potential
1542,1845,22,7,9342.199999999999,3,3,4,10,Highly potential
1543,1846,334,1,441.49,1,1,1,3,Require Activation
1544,1847,33,3,3921.92,3,1,1,5,Promising
1545,1848,43,6,8432.48,3,3,4,10,Highly potential
1546,1850,45,7,7706.74,3,3,3,9,Highly potential
1547,1851,286,2,2498.86,1,1,1,3,Require Activation
1548,1852,98,5,7030.61,1,2,3,6,Loyal
1549,1853,27,9,8957.8,3,4,4,11,Highly potential
1550,1854,1,3,3384.5600000000004,4,1,1,6,Loyal
1551,1855,23,4,3648.1,3,1,1,5,Promising
1552,1856,128,2,1134.63,1,1,1,3,Require Activation
1553,1857,88,4,6171.18,2,1,3,6,Loyal
1554,1859,77,5,6599.45,2,2,3,7,Require Activation
1555,1860,12,6,7424.780000000001,4,3,3,10,Highly potential
1556,1861,30,6,7073.07,3,3,3,9,Highly potential
1557,1863,247,5,7359.9,1,2,3,6,Loyal
1558,1864,25,10,7448.480000000001,3,4,3,10,Highly potential
1559,1865,100,1,1071.23,1,1,1,3,Require Activation
1560,1866,39,9,12450.76,3,4,4,11,Highly potential
1561,1867,3,8,11055.86,4,4,4,12,Highly potential
1562,1868,27,6,10105.23,3,3,4,10,Highly potential
1563,1869,42,4,3260.5899999999997,3,1,1,5,Promising
1564,1870,39,7,7755.759999999999,3,3,3,9,Highly potential
1565,1871,95,4,3787.2699999999995,1,1,1,3,Require Activation
1566,1872,140,5,5719.53,1,2,2,5,Promising
1567,1873,9,4,5930.68,4,1,3,8,Require Activation
1568,1875,99,6,6549.05,1,3,3,7,Require Activation
1569,1876,139,5,10115.02,1,2,4,7,Require Activation
1570,1877,81,6,4192.31,2,3,2,7,Require Activation
1571,1878,33,6,6231.589999999999,3,3,3,9,Highly potential
1572,1879,48,7,5332.889999999999,2,3,2,7,Require Activation
1573,1881,36,7,8559.33,3,3,4,10,Highly potential
1574,1882,129,6,5862.02,1,3,2,6,Loyal
1575,1885,5,9,10587.230000000001,4,4,4,12,Highly potential
1576,1886,7,4,4591.32,4,1,2,7,Require Activation
1577,1887,106,10,15364.289999999999,1,4,4,9,Highly potential
1578,1888,88,4,5775.32,2,1,2,5,Promising
1579,1890,45,9,10862.91,3,4,4,11,Highly potential
1580,1891,82,7,9203.4,2,3,4,9,Highly potential
1581,1893,3,7,7903.94,4,3,3,10,Highly potential
1582,1894,37,4,3591.0299999999997,3,1,1,5,Promising
1583,1895,8,5,2110.2599999999998,4,2,1,7,Require Activation
1584,1896,160,3,3843.92,1,1,1,3,Require Activation
1585,1897,63,7,5120.75,2,3,2,7,Require Activation
1586,1898,61,6,7885.110000000001,2,3,3,8,Require Activation
1587,1900,68,4,3327.9399999999996,2,1,1,4,Needs Attention
1588,1901,128,7,10098.550000000001,1,3,4,8,Require Activation
1589,1902,53,5,5226.46,2,2,2,6,Loyal
1590,1903,17,4,6548.9400000000005,4,1,3,8,Require Activation
1591,1904,68,3,1954.46,2,1,1,4,Needs Attention
1592,1906,2,6,5992.34,4,3,3,10,Highly potential
1593,1907,111,4,3740.6000000000004,1,1,1,3,Require Activation
1594,1908,108,6,7578.920000000001,1,3,3,7,Require Activation
1595,1909,60,6,5543.2,2,3,2,7,Require Activation
1596,1910,18,3,3041.75,4,1,1,6,Loyal
1597,1911,62,2,3156.3599999999997,2,1,1,4,Needs Attention
1598,1912,39,9,7048.1900000000005,3,4,3,10,Highly potential
1599,1913,43,13,8621.869999999999,3,4,4,11,Highly potential
1600,1914,13,8,7833.69,4,4,3,11,Highly potential
1601,1915,62,5,4749.41,2,2,2,6,Loyal
1602,1916,54,7,7436.050000000001,2,3,3,8,Require Activation
1603,1917,29,7,9783.66,3,3,4,10,Highly potential
1604,1919,45,4,3935.23,3,1,1,5,Promising
1605,1920,70,1,360.4,2,1,1,4,Needs Attention
1606,1921,41,1,586.45,3,1,1,5,Promising
1607,1922,94,3,3352.52,1,1,1,3,Require Activation
1608,1923,16,4,3704.94,4,1,1,6,Loyal
1609,1924,26,3,4133.389999999999,3,1,2,6,Loyal
1610,1926,6,5,7762.71,4,2,3,9,Highly potential
1611,1927,91,5,6439.16,1,2,3,6,Loyal
1612,1928,35,2,2219.84,3,1,1,5,Promising
1613,1929,46,6,3442.2,2,3,1,6,Loyal
1614,1930,22,5,6575.57,3,2,3,8,Require Activation
1615,1931,24,3,2218.5,3,1,1,5,Promising
1616,1932,90,8,12027.439999999999,1,4,4,9,Highly potential
1617,1933,42,8,10647.53,3,4,4,11,Highly potential
1618,1934,4,6,6431.09,4,3,3,10,Highly potential
1619,1936,78,8,9673.2,2,4,4,10,Highly potential
1620,1937,35,6,8393.86,3,3,4,10,Highly potential
1621,1939,77,2,806.18,2,1,1,4,Needs Attention
1622,1940,77,4,6093.61,2,1,3,6,Loyal
1623,1941,6,4,4645.6900000000005,4,1,2,7,Require Activation
1624,1942,17,8,6241.37,4,4,3,11,Highly potential
1625,1943,300,3,2075.7799999999997,1,1,1,3,Require Activation
1626,1944,6,5,5704.360000000001,4,2,2,8,Require Activation
1627,1945,116,3,2551.62,1,1,1,3,Require Activation
1628,1946,89,13,11237.38,2,4,4,10,Highly potential
1629,1947,36,9,8225.63,3,4,4,11,Highly potential
1630,1949,30,7,8547.61,3,3,4,10,Highly potential
1631,1950,7,9,12108.45,4,4,4,12,Highly potential
1632,1951,119,8,6977.97,1,4,3,8,Require Activation
1633,1952,77,10,7870.000000000001,2,4,3,9,Highly potential
1634,1953,11,7,6386.97,4,3,3,10,Highly potential
1635,1954,101,8,9484.04,1,4,4,9,Highly potential
1636,1955,79,3,3235.83,2,1,1,4,Needs Attention
1637,1956,34,4,3039.79,3,1,1,5,Promising
1638,1957,20,10,11536.57,3,4,4,11,Highly potential
1639,1958,70,4,2389.99,2,1,1,4,Needs Attention
1640,1959,142,8,7593.28,1,4,3,8,Require Activation
1641,1960,70,3,4742.2,2,1,2,5,Promising
1642,1961,26,3,4600.36,3,1,2,6,Loyal
1643,1962,94,2,1385.6,1,1,1,3,Require Activation
1644,1963,10,2,2683.29,4,1,1,6,Loyal
1645,1964,103,6,8039.189999999999,1,3,4,8,Require Activation
1646,1965,7,5,4201.570000000001,4,2,2,8,Require Activation
1647,1968,160,5,4664.660000000001,1,2,2,5,Promising
1648,1969,18,6,6142.67,4,3,3,10,Highly potential
1649,1970,1,8,8590.23,4,4,4,12,Highly potential
1650,1973,48,4,4932.1,2,1,2,5,Promising
1651,1974,33,5,3780.4500000000007,3,2,1,6,Loyal
1652,1975,109,2,661.42,1,1,1,3,Require Activation
1653,1976,136,6,6246.070000000001,1,3,3,7,Require Activation
1654,1978,14,3,2048.2599999999998,4,1,1,6,Loyal
1655,1979,34,5,8062.73,3,2,4,9,Highly potential
1656,1980,74,8,9465.38,2,4,4,10,Highly potential
1657,1981,90,3,4850.6900000000005,1,1,2,4,Needs Attention
1658,1982,51,8,10897.339999999998,2,4,4,10,Highly potential
1659,1983,3,4,5795.41,4,1,2,7,Require Activation
1660,1984,49,7,10526.430000000002,2,3,4,9,Highly potential
1661,1985,1,7,7022.759999999999,4,3,3,10,Highly potential
1662,1987,43,4,3721.38,3,1,1,5,Promising
1663,1988,135,8,10687.63,1,4,4,9,Highly potential
1664,1989,23,4,5139.46,3,1,2,6,Loyal
1665,1991,2,10,12813.27,4,4,4,12,Highly potential
1666,1992,141,10,14165.05,1,4,4,9,Highly potential
1667,1993,75,8,8421.95,2,4,4,10,Highly potential
1668,1995,126,6,5245.66,1,3,2,6,Loyal
1669,1996,14,7,6300.450000000001,4,3,3,10,Highly potential
1670,1997,55,5,4713.719999999999,2,2,2,6,Loyal
1671,1998,157,4,5359.34,1,1,2,4,Needs Attention
1672,1999,4,7,8432.98,4,3,4,11,Highly potential
1673,2001,87,8,10016.79,2,4,4,10,Highly potential
1674,2002,98,3,2637.04,1,1,1,3,Require Activation
1675,2003,220,2,1821.05,1,1,1,3,Require Activation
1676,2004,47,5,6042.51,2,2,3,7,Require Activation
1677,2005,6,6,7337.820000000001,4,3,3,10,Highly potential
1678,2006,148,5,6192.77,1,2,3,6,Loyal
1679,2007,24,3,5180.32,3,1,2,6,Loyal
1680,2008,30,7,7961.950000000001,3,3,3,9,Highly potential
1681,2009,6,7,7073.18,4,3,3,10,Highly potential
1682,2010,35,5,5466.66,3,2,2,7,Require Activation
1683,2011,316,3,2057.82,1,1,1,3,Require Activation
1684,2012,14,5,5492.34,4,2,2,8,Require Activation
1685,2013,16,9,7999.33,4,4,3,11,Highly potential
1686,2014,55,6,5544.87,2,3,2,7,Require Activation
1687,2015,51,6,7253.270000000001,2,3,3,8,Require Activation
1688,2016,69,6,5897.5599999999995,2,3,3,8,Require Activation
1689,2017,13,5,5612.86,4,2,2,8,Require Activation
1690,2018,36,7,7597.120000000001,3,3,3,9,Highly potential
1691,2019,53,8,9082.85,2,4,4,10,Highly potential
1692,2020,44,7,8810.74,3,3,4,10,Highly potential
1693,2023,14,10,10149.329999999998,4,4,4,12,Highly potential
1694,2024,30,6,5998.77,3,3,3,9,Highly potential
1695,2025,139,4,4120.88,1,1,2,4,Needs Attention
1696,2026,147,4,6109.3,1,1,3,5,Promising
1697,2027,15,7,6353.8099999999995,4,3,3,10,Highly potential
1698,2028,41,7,7274.75,3,3,3,9,Highly potential
1699,2029,2,9,6555.91,4,4,3,11,Highly potential
1700,2030,240,4,6169.620000000001,1,1,3,5,Promising
1701,2031,20,4,4477.1900000000005,3,1,2,6,Loyal
1702,2032,6,2,1640.3,4,1,1,6,Loyal
1703,2033,12,7,10152.519999999999,4,3,4,11,Highly potential
1704,2034,90,6,6954.370000000001,1,3,3,7,Require Activation
1705,2035,128,4,3371.7999999999997,1,1,1,3,Require Activation
1706,2037,99,4,4403.780000000001,1,1,2,4,Needs Attention
1707,2038,14,4,4230.27,4,1,2,7,Require Activation
1708,2039,200,5,5594.110000000001,1,2,2,5,Promising
1709,2040,97,2,3028.8900000000003,1,1,1,3,Require Activation
1710,2041,81,6,7729.639999999999,2,3,3,8,Require Activation
1711,2042,12,3,4170.51,4,1,2,7,Require Activation
1712,2043,140,5,6704.41,1,2,3,6,Loyal
1713,2044,6,5,7468.57,4,2,3,9,Highly potential
1714,2045,56,9,9255.03,2,4,4,10,Highly potential
1715,2046,34,9,13347.529999999999,3,4,4,11,Highly potential
1716,2047,280,1,1289.85,1,1,1,3,Require Activation
1717,2048,58,7,8820.57,2,3,4,9,Highly potential
1718,2049,66,6,7403.760000000001,2,3,3,8,Require Activation
1719,2050,7,4,4483.5,4,1,2,7,Require Activation
1720,2051,52,6,7376.929999999999,2,3,3,8,Require Activation
1721,2055,1,9,12172.04,4,4,4,12,Highly potential
1722,2056,55,2,1829.4899999999998,2,1,1,4,Needs Attention
1723,2057,17,6,6889.26,4,3,3,10,Highly potential
1724,2058,121,7,7546.98,1,3,3,7,Require Activation
1725,2059,171,4,2702.14,1,1,1,3,Require Activation
1726,2060,6,11,11179.22,4,4,4,12,Highly potential
1727,2062,43,5,6976.84,3,2,3,8,Require Activation
1728,2063,10,5,4125.82,4,2,2,8,Require Activation
1729,2064,107,5,5871.14,1,2,2,5,Promising
1730,2065,216,4,4870.0599999999995,1,1,2,4,Needs Attention
1731,2066,91,5,6115.09,1,2,3,6,Loyal
1732,2067,31,8,9622.05,3,4,4,11,Highly potential
1733,2068,160,5,5158.92,1,2,2,5,Promising
1734,2070,5,8,10228.07,4,4,4,12,Highly potential
1735,2072,9,13,11845.44,4,4,4,12,Highly potential
1736,2075,5,4,5575.410000000001,4,1,2,7,Require Activation
1737,2076,20,8,12082.720000000001,3,4,4,11,Highly potential
1738,2077,228,3,4642.2,1,1,2,4,Needs Attention
1739,2078,66,6,7319.86,2,3,3,8,Require Activation
1740,2080,163,6,6668.6,1,3,3,7,Require Activation
1741,2081,12,5,5586.19,4,2,2,8,Require Activation
1742,2082,2,7,6778.84,4,3,3,10,Highly potential
1743,2085,28,3,4294.139999999999,3,1,2,6,Loyal
1744,2086,99,3,3812.2200000000003,1,1,1,3,Require Activation
1745,2087,56,5,6577.630000000001,2,2,3,7,Require Activation
1746,2088,10,7,8654.02,4,3,4,11,Highly potential
1747,2089,148,2,477.32000000000005,1,1,1,3,Require Activation
1748,2090,164,2,1020.78,1,1,1,3,Require Activation
1749,2091,212,3,5499.04,1,1,2,4,Needs Attention
1750,2092,17,5,6764.390000000001,4,2,3,9,Highly potential
1751,2093,61,6,7654.84,2,3,3,8,Require Activation
1752,2094,35,5,4214.53,3,2,2,7,Require Activation
1753,2095,21,10,9988.760000000002,3,4,4,11,Highly potential
1754,2096,133,5,8229.84,1,2,4,7,Require Activation
1755,2097,39,6,7726.09,3,3,3,9,Highly potential
1756,2098,9,6,5472.619999999999,4,3,2,9,Highly potential
1757,2099,64,7,8967.039999999999,2,3,4,9,Highly potential
1758,2100,19,5,4288.18,4,2,2,8,Require Activation
1759,2102,18,7,7317.460000000001,4,3,3,10,Highly potential
1760,2103,15,10,11617.25,4,4,4,12,Highly potential
1761,2104,81,8,7415.839999999999,2,4,3,9,Highly potential
1762,2105,24,5,7196.769999999999,3,2,3,8,Require Activation
1763,2106,4,4,6782.280000000001,4,1,3,8,Require Activation
1764,2107,65,2,1941.0,2,1,1,4,Needs Attention
1765,2108,13,3,3130.2599999999998,4,1,1,6,Loyal
1766,2109,3,8,7637.120000000001,4,4,3,11,Highly potential
1767,2110,27,7,7589.570000000001,3,3,3,9,Highly potential
1768,2111,7,9,11111.3,4,4,4,12,Highly potential
1769,2112,3,4,5958.11,4,1,3,8,Require Activation
1770,2113,34,4,4987.47,3,1,2,6,Loyal
1771,2114,15,6,6706.459999999999,4,3,3,10,Highly potential
1772,2115,48,2,2204.45,2,1,1,4,Needs Attention
1773,2116,106,4,5827.959999999999,1,1,2,4,Needs Attention
1774,2117,25,5,3925.1699999999996,3,2,1,6,Loyal
1775,2118,136,6,6724.400000000001,1,3,3,7,Require Activation
1776,2119,68,4,5477.6,2,1,2,5,Promising
1777,2120,3,8,11028.33,4,4,4,12,Highly potential
1778,2121,90,9,10142.52,1,4,4,9,Highly potential
1779,2122,9,3,2424.17,4,1,1,6,Loyal
1780,2123,196,6,6196.0199999999995,1,3,3,7,Require Activation
1781,2125,14,6,4206.48,4,3,2,9,Highly potential
1782,2126,26,4,2963.04,3,1,1,5,Promising
1783,2127,33,5,5437.05,3,2,2,7,Require Activation
1784,2128,14,2,3787.46,4,1,1,6,Loyal
1785,2129,150,2,1411.9299999999998,1,1,1,3,Require Activation
1786,2130,2,8,9169.4,4,4,4,12,Highly potential
1787,2131,102,5,5423.2300000000005,1,2,2,5,Promising
1788,2132,19,8,12668.239999999998,4,4,4,12,Highly potential
1789,2133,121,5,6553.4400000000005,1,2,3,6,Loyal
1790,2134,82,5,6556.68,2,2,3,7,Require Activation
1791,2135,339,1,1977.36,1,1,1,3,Require Activation
1792,2136,11,4,6269.92,4,1,3,8,Require Activation
1793,2138,44,7,9725.78,3,3,4,10,Highly potential
1794,2139,61,5,7480.9400000000005,2,2,3,7,Require Activation
1795,2140,99,8,9047.439999999999,1,4,4,9,Highly potential
1796,2141,77,4,4820.85,2,1,2,5,Promising
1797,2142,82,7,10200.020000000002,2,3,4,9,Highly potential
1798,2143,28,4,5641.38,3,1,2,6,Loyal
1799,2144,68,8,10452.24,2,4,4,10,Highly potential
1800,2145,195,1,748.17,1,1,1,3,Require Activation
1801,2147,126,3,2953.18,1,1,1,3,Require Activation
1802,2148,138,4,4907.04,1,1,2,4,Needs Attention
1803,2149,12,9,7062.67,4,4,3,11,Highly potential
1804,2152,2,9,9894.84,4,4,4,12,Highly potential
1805,2154,39,6,7924.87,3,3,3,9,Highly potential
1806,2155,20,11,8886.39,3,4,4,11,Highly potential
1807,2156,114,6,6988.71,1,3,3,7,Require Activation
1808,2157,162,2,2131.52,1,1,1,3,Require Activation
1809,2158,51,5,5982.299999999999,2,2,3,7,Require Activation
1810,2160,48,6,6852.88,2,3,3,8,Require Activation
1811,2162,54,4,4785.389999999999,2,1,2,5,Promising
1812,2163,71,4,3236.7,2,1,1,4,Needs Attention
1813,2164,69,7,8585.810000000001,2,3,4,9,Highly potential
1814,2166,59,6,6021.83,2,3,3,8,Require Activation
1815,2167,145,6,4691.02,1,3,2,6,Loyal
1816,2168,3,3,3828.0999999999995,4,1,1,6,Loyal
1817,2169,118,5,8555.14,1,2,4,7,Require Activation
1818,2170,29,6,7695.750000000001,3,3,3,9,Highly potential
1819,2171,35,6,4500.04,3,3,2,8,Require Activation
1820,2172,30,4,6844.5,3,1,3,7,Require Activation
1821,2173,158,4,5112.15,1,1,2,4,Needs Attention
1822,2174,82,5,6589.830000000001,2,2,3,7,Require Activation
1823,2175,59,4,4158.65,2,1,2,5,Promising
1824,2176,29,3,2662.8199999999997,3,1,1,5,Promising
1825,2177,99,5,6054.2699999999995,1,2,3,6,Loyal
1826,2178,78,4,3531.6400000000003,2,1,1,4,Needs Attention
1827,2179,37,7,6889.21,3,3,3,9,Highly potential
1828,2180,81,5,6162.33,2,2,3,7,Require Activation
1829,2181,52,8,6274.12,2,4,3,9,Highly potential
1830,2182,18,8,10722.16,4,4,4,12,Highly potential
1831,2183,9,14,19071.32,4,4,4,12,Highly potential
1832,2184,38,11,13468.260000000002,3,4,4,11,Highly potential
1833,2185,137,7,9578.97,1,3,4,8,Require Activation
1834,2186,155,3,4245.21,1,1,2,4,Needs Attention
1835,2187,64,7,8284.37,2,3,4,9,Highly potential
1836,2188,71,6,6671.539999999999,2,3,3,8,Require Activation
1837,2191,13,5,7172.5599999999995,4,2,3,9,Highly potential
1838,2192,43,4,2098.19,3,1,1,5,Promising
1839,2193,55,4,6086.66,2,1,3,6,Loyal
1840,2194,43,8,8464.84,3,4,4,11,Highly potential
1841,2195,3,5,7266.61,4,2,3,9,Highly potential
1842,2196,72,5,4425.25,2,2,2,6,Loyal
1843,2197,120,3,2284.5600000000004,1,1,1,3,Require Activation
1844,2198,26,3,2366.21,3,1,1,5,Promising
1845,2199,25,4,4628.71,3,1,2,6,Loyal
1846,2200,139,2,2208.44,1,1,1,3,Require Activation
1847,2201,31,7,10466.460000000001,3,3,4,10,Highly potential
1848,2202,59,10,8507.06,2,4,4,10,Highly potential
1849,2203,50,5,6421.1,2,2,3,7,Require Activation
1850,2204,18,8,7935.08,4,4,3,11,Highly potential
1851,2206,59,4,4155.32,2,1,2,5,Promising
1852,2207,75,6,6263.82,2,3,3,8,Require Activation
1853,2209,266,1,1240.31,1,1,1,3,Require Activation
1854,2210,28,9,8133.83,3,4,4,11,Highly potential
1855,2212,42,6,4951.08,3,3,2,8,Require Activation
1856,2213,16,5,7240.499999999999,4,2,3,9,Highly potential
1857,2215,20,2,1965.6799999999998,3,1,1,5,Promising
1858,2216,75,3,3352.32,2,1,1,4,Needs Attention
1859,2217,23,7,6891.280000000001,3,3,3,9,Highly potential
1860,2218,22,3,4304.09,3,1,2,6,Loyal
1861,2219,62,5,6319.34,2,2,3,7,Require Activation
1862,2220,86,4,4529.9,2,1,2,5,Promising
1863,2221,95,8,9100.52,1,4,4,9,Highly potential
1864,2222,60,6,7051.67,2,3,3,8,Require Activation
1865,2223,55,7,5883.75,2,3,2,7,Require Activation
1866,2224,288,3,2568.2200000000003,1,1,1,3,Require Activation
1867,2225,209,3,5546.3099999999995,1,1,2,4,Needs Attention
1868,2226,50,8,8295.550000000001,2,4,4,10,Highly potential
1869,2227,41,5,5068.82,3,2,2,7,Require Activation
1870,2228,169,4,3579.45,1,1,1,3,Require Activation
1871,2229,22,4,3937.92,3,1,1,5,Promising
1872,2231,65,3,4555.37,2,1,2,5,Promising
1873,2232,60,6,5666.03,2,3,2,7,Require Activation
1874,2233,64,7,6778.259999999998,2,3,3,8,Require Activation
1875,2234,58,6,3299.5800000000004,2,3,1,6,Loyal
1876,2235,81,6,7834.270000000001,2,3,3,8,Require Activation
1877,2236,2,3,4226.47,4,1,2,7,Require Activation
1878,2238,142,3,4185.99,1,1,2,4,Needs Attention
1879,2239,33,2,1693.21,3,1,1,5,Promising
1880,2240,32,12,13961.45,3,4,4,11,Highly potential
1881,2241,18,4,4335.0,4,1,2,7,Require Activation
1882,2242,171,3,2540.1099999999997,1,1,1,3,Require Activation
1883,2243,184,3,2141.05,1,1,1,3,Require Activation
1884,2244,64,5,5963.92,2,2,3,7,Require Activation
1885,2245,75,7,7779.899999999999,2,3,3,8,Require Activation
1886,2246,100,4,4027.99,1,1,1,3,Require Activation
1887,2247,30,7,8149.48,3,3,4,10,Highly potential
1888,2248,52,8,8369.31,2,4,4,10,Highly potential
1889,2253,85,6,7418.94,2,3,3,8,Require Activation
1890,2254,4,5,5373.7,4,2,2,8,Require Activation
1891,2255,144,2,3277.4700000000003,1,1,1,3,Require Activation
1892,2256,170,3,4499.85,1,1,2,4,Needs Attention
1893,2257,65,5,6440.81,2,2,3,7,Require Activation
1894,2258,53,6,7710.900000000001,2,3,3,8,Require Activation
1895,2259,162,4,4205.21,1,1,2,4,Needs Attention
1896,2260,18,6,8234.9,4,3,4,11,Highly potential
1897,2261,36,4,3875.6099999999997,3,1,1,5,Promising
1898,2262,76,4,3058.55,2,1,1,4,Needs Attention
1899,2263,36,5,6359.93,3,2,3,8,Require Activation
1900,2264,154,6,5198.18,1,3,2,6,Loyal
1901,2267,100,5,5466.639999999999,1,2,2,5,Promising
1902,2268,36,8,9258.43,3,4,4,11,Highly potential
1903,2269,48,7,9233.33,2,3,4,9,Highly potential
1904,2270,130,5,7588.289999999999,1,2,3,6,Loyal
1905,2272,105,6,8116.8,1,3,4,8,Require Activation
1906,2273,27,10,9867.35,3,4,4,11,Highly potential
1907,2274,56,2,142.98,2,1,1,4,Needs Attention
1908,2275,122,6,8289.0,1,3,4,8,Require Activation
1909,2276,11,4,4714.45,4,1,2,7,Require Activation
1910,2277,37,4,4721.53,3,1,2,6,Loyal
1911,2278,35,4,1635.24,3,1,1,5,Promising
1912,2279,36,8,7565.699999999999,3,4,3,10,Highly potential
1913,2280,25,5,6373.32,3,2,3,8,Require Activation
1914,2282,15,6,6818.610000000001,4,3,3,10,Highly potential
1915,2283,31,7,7052.93,3,3,3,9,Highly potential
1916,2284,35,7,7556.939999999999,3,3,3,9,Highly potential
1917,2285,40,7,4829.539999999999,3,3,2,8,Require Activation
1918,2286,50,5,4606.01,2,2,2,6,Loyal
1919,2287,160,2,1083.52,1,1,1,3,Require Activation
1920,2288,30,6,6972.7,3,3,3,9,Highly potential
1921,2289,60,4,4560.12,2,1,2,5,Promising
1922,2290,73,5,5602.610000000001,2,2,2,6,Loyal
1923,2291,108,1,792.9,1,1,1,3,Require Activation
1924,2292,46,7,8732.62,2,3,4,9,Highly potential
1925,2293,86,5,5018.52,2,2,2,6,Loyal
1926,2294,74,7,9680.22,2,3,4,9,Highly potential
1927,2296,37,4,5259.05,3,1,2,6,Loyal
1928,2297,38,5,6232.6900000000005,3,2,3,8,Require Activation
1929,2298,46,6,6997.85,2,3,3,8,Require Activation
1930,2299,60,6,4359.320000000001,2,3,2,7,Require Activation
1931,2301,6,6,9265.95,4,3,4,11,Highly potential
1932,2302,54,3,4412.84,2,1,2,5,Promising
1933,2303,145,2,2696.8599999999997,1,1,1,3,Require Activation
1934,2305,79,5,6011.6900000000005,2,2,3,7,Require Activation
1935,2306,7,4,4938.639999999999,4,1,2,7,Require Activation
1936,2307,82,11,10123.710000000001,2,4,4,10,Highly potential
1937,2308,14,9,11438.37,4,4,4,12,Highly potential
1938,2309,54,12,16122.339999999997,2,4,4,10,Highly potential
1939,2310,16,6,8126.880000000001,4,3,4,11,Highly potential
1940,2312,29,5,7250.51,3,2,3,8,Require Activation
1941,2313,45,6,4657.799999999999,3,3,2,8,Require Activation
1942,2314,49,3,4114.37,2,1,2,5,Promising
1943,2315,153,5,2737.8,1,2,1,4,Needs Attention
1944,2316,47,4,2908.85,2,1,1,4,Needs Attention
1945,2317,54,5,6735.95,2,2,3,7,Require Activation
1946,2318,17,7,8129.61,4,3,4,11,Highly potential
1947,2319,10,4,7191.200000000001,4,1,3,8,Require Activation
1948,2320,25,3,2655.46,3,1,1,5,Promising
1949,2321,162,3,5473.58,1,1,2,4,Needs Attention
1950,2322,68,4,4035.51,2,1,1,4,Needs Attention
1951,2323,213,3,4599.45,1,1,2,4,Needs Attention
1952,2324,79,4,4867.58,2,1,2,5,Promising
1953,2325,122,5,6019.48,1,2,3,6,Loyal
1954,2326,113,1,774.53,1,1,1,3,Require Activation
1955,2327,225,3,4153.11,1,1,2,4,Needs Attention
1956,2328,152,1,441.49,1,1,1,3,Require Activation
1957,2329,9,5,4252.36,4,2,2,8,Require Activation
1958,2330,5,3,2391.06,4,1,1,6,Loyal
1959,2331,20,7,5341.04,3,3,2,8,Require Activation
1960,2332,32,4,1972.9,3,1,1,5,Promising
1961,2333,93,4,5216.820000000001,1,1,2,4,Needs Attention
1962,2334,70,3,3616.74,2,1,1,4,Needs Attention
1963,2336,75,9,10942.55,2,4,4,10,Highly potential
1964,2337,173,3,2169.36,1,1,1,3,Require Activation
1965,2338,24,7,7546.18,3,3,3,9,Highly potential
1966,2339,12,8,8958.4,4,4,4,12,Highly potential
1967,2340,6,9,9442.23,4,4,4,12,Highly potential
1968,2343,63,3,4215.4,2,1,2,5,Promising
1969,2344,48,6,6947.299999999999,2,3,3,8,Require Activation
1970,2345,1,4,6939.88,4,1,3,8,Require Activation
1971,2346,163,5,6429.33,1,2,3,6,Loyal
1972,2347,88,9,10730.51,2,4,4,10,Highly potential
1973,2348,61,4,2451.77,2,1,1,4,Needs Attention
1974,2349,55,5,3608.1399999999994,2,2,1,5,Promising
1975,2350,181,4,3747.5,1,1,1,3,Require Activation
1976,2351,56,7,6531.820000000001,2,3,3,8,Require Activation
1977,2352,37,1,1292.84,3,1,1,5,Promising
1978,2353,82,10,11013.74,2,4,4,10,Highly potential
1979,2354,37,5,4817.55,3,2,2,7,Require Activation
1980,2356,147,4,5020.2699999999995,1,1,2,4,Needs Attention
1981,2357,41,4,5811.12,3,1,2,6,Loyal
1982,2358,4,11,8523.43,4,4,4,12,Highly potential
1983,2359,83,8,9029.74,2,4,4,10,Highly potential
1984,2360,28,6,8601.41,3,3,4,10,Highly potential
1985,2361,23,7,7640.51,3,3,3,9,Highly potential
1986,2362,46,3,3007.23,2,1,1,4,Needs Attention
1987,2363,59,6,5473.37,2,3,2,7,Require Activation
1988,2364,44,5,8404.81,3,2,4,9,Highly potential
1989,2365,2,5,5448.58,4,2,2,8,Require Activation
1990,2366,20,5,5543.950000000001,3,2,2,7,Require Activation
1991,2367,26,6,7931.35,3,3,3,9,Highly potential
1992,2368,75,6,7617.1,2,3,3,8,Require Activation
1993,2369,2,8,11223.939999999999,4,4,4,12,Highly potential
1994,2370,21,3,3107.9700000000003,3,1,1,5,Promising
1995,2371,94,5,7720.099999999999,1,2,3,6,Loyal
1996,2372,1,9,8295.0,4,4,4,12,Highly potential
1997,2373,46,4,4758.44,2,1,2,5,Promising
1998,2374,15,7,7495.68,4,3,3,10,Highly potential
1999,2375,44,7,9972.86,3,3,4,10,Highly potential
2000,2376,12,3,3621.9700000000003,4,1,1,6,Loyal
2001,2377,8,5,8081.98,4,2,4,10,Highly potential
2002,2378,11,5,5040.64,4,2,2,8,Require Activation
2003,2379,4,11,13030.07,4,4,4,12,Highly potential
2004,2380,43,6,6658.59,3,3,3,9,Highly potential
2005,2381,30,7,7877.93,3,3,3,9,Highly potential
2006,2382,39,7,3369.77,3,3,1,7,Require Activation
2007,2383,22,9,13104.08,3,4,4,11,Highly potential
2008,2384,60,6,5845.17,2,3,2,7,Require Activation
2009,2385,32,8,7901.9400000000005,3,4,3,10,Highly potential
2010,2386,13,7,7710.120000000001,4,3,3,10,Highly potential
2011,2387,183,2,591.31,1,1,1,3,Require Activation
2012,2388,114,7,10013.26,1,3,4,8,Require Activation
2013,2389,9,3,2456.1800000000003,4,1,1,6,Loyal
2014,2390,70,6,8204.630000000001,2,3,4,9,Highly potential
2015,2391,13,10,10874.649999999998,4,4,4,12,Highly potential
2016,2392,27,5,5215.179999999999,3,2,2,7,Require Activation
2017,2393,123,2,1228.76,1,1,1,3,Require Activation
2018,2394,91,1,980.37,1,1,1,3,Require Activation
2019,2395,63,1,230.91,2,1,1,4,Needs Attention
2020,2396,1,4,4326.13,4,1,2,7,Require Activation
2021,2397,54,9,10464.009999999998,2,4,4,10,Highly potential
2022,2399,39,6,6424.4400000000005,3,3,3,9,Highly potential
2023,2400,20,8,10452.28,3,4,4,11,Highly potential
2024,2401,22,8,10935.93,3,4,4,11,Highly potential
2025,2402,79,3,4490.75,2,1,2,5,Promising
2026,2403,151,5,3202.84,1,2,1,4,Needs Attention
2027,2404,188,5,7607.199999999999,1,2,3,6,Loyal
2028,2405,46,5,2817.81,2,2,1,5,Promising
2029,2406,81,4,4117.37,2,1,2,5,Promising
2030,2410,37,6,6772.0199999999995,3,3,3,9,Highly potential
2031,2411,224,4,6535.389999999999,1,1,3,5,Promising
2032,2412,18,6,7097.64,4,3,3,10,Highly potential
2033,2413,59,7,8666.869999999999,2,3,4,9,Highly potential
2034,2415,44,5,4412.09,3,2,2,7,Require Activation
2035,2416,223,2,2220.23,1,1,1,3,Require Activation
2036,2417,23,1,1129.13,3,1,1,5,Promising
2037,2418,3,7,9068.28,4,3,4,11,Highly potential
2038,2419,52,8,8651.869999999999,2,4,4,10,Highly potential
2039,2420,140,3,2367.71,1,1,1,3,Require Activation
2040,2421,1,6,2836.38,4,3,1,8,Require Activation
2041,2422,33,5,4670.18,3,2,2,7,Require Activation
2042,2423,60,1,202.62,2,1,1,4,Needs Attention
2043,2425,9,9,8310.5,4,4,4,12,Highly potential
2044,2427,4,6,7962.360000000001,4,3,3,10,Highly potential
2045,2428,38,8,9038.359999999999,3,4,4,11,Highly potential
2046,2429,223,3,3811.29,1,1,1,3,Require Activation
2047,2430,116,4,3385.21,1,1,1,3,Require Activation
2048,2431,219,2,1447.1799999999998,1,1,1,3,Require Activation
2049,2432,41,5,3930.31,3,2,1,6,Loyal
2050,2433,27,10,10945.11,3,4,4,11,Highly potential
2051,2434,1,9,10024.41,4,4,4,12,Highly potential
2052,2435,124,5,6950.49,1,2,3,6,Loyal
2053,2436,17,4,3919.84,4,1,1,6,Loyal
2054,2437,199,2,1436.8,1,1,1,3,Require Activation
2055,2438,28,7,6007.49,3,3,3,9,Highly potential
2056,2440,54,4,5001.4400000000005,2,1,2,5,Promising
2057,2442,81,6,5014.14,2,3,2,7,Require Activation
2058,2443,13,6,6182.680000000001,4,3,3,10,Highly potential
2059,2444,45,4,5166.360000000001,3,1,2,6,Loyal
2060,2445,18,5,5245.210000000001,4,2,2,8,Require Activation
2061,2447,40,7,7729.639999999999,3,3,3,9,Highly potential
2062,2448,7,6,5418.88,4,3,2,9,Highly potential
2063,2449,77,5,6836.960000000001,2,2,3,7,Require Activation
2064,2450,41,2,3861.74,3,1,1,5,Promising
2065,2451,18,3,3247.8500000000004,4,1,1,6,Loyal
2066,2452,10,4,4209.71,4,1,2,7,Require Activation
2067,2453,57,6,4683.469999999999,2,3,2,7,Require Activation
2068,2454,30,10,11477.219999999998,3,4,4,11,Highly potential
2069,2456,168,5,5167.12,1,2,2,5,Promising
2070,2457,53,6,8023.24,2,3,4,9,Highly potential
2071,2458,5,7,11224.23,4,3,4,11,Highly potential
2072,2459,54,11,11877.189999999999,2,4,4,10,Highly potential
2073,2460,51,4,4291.639999999999,2,1,2,5,Promising
2074,2462,25,6,5779.98,3,3,2,8,Require Activation
2075,2463,65,8,9906.890000000001,2,4,4,10,Highly potential
2076,2464,3,13,14574.06,4,4,4,12,Highly potential
2077,2465,12,9,9114.46,4,4,4,12,Highly potential
2078,2466,20,5,4796.14,3,2,2,7,Require Activation
2079,2467,22,5,2590.13,3,2,1,6,Loyal
2080,2468,22,9,11893.32,3,4,4,11,Highly potential
2081,2471,14,5,5699.45,4,2,2,8,Require Activation
2082,2472,86,6,7612.35,2,3,3,8,Require Activation
2083,2474,65,7,7884.07,2,3,3,8,Require Activation
2084,2475,86,7,10009.91,2,3,4,9,Highly potential
2085,2476,15,14,14578.689999999999,4,4,4,12,Highly potential
2086,2477,41,1,2005.66,3,1,1,5,Promising
2087,2478,115,6,4323.68,1,3,2,6,Loyal
2088,2479,3,6,2933.17,4,3,1,8,Require Activation
2089,2480,43,5,6781.5,3,2,3,8,Require Activation
2090,2481,21,7,5825.4,3,3,2,8,Require Activation
2091,2482,233,3,3110.6899999999996,1,1,1,3,Require Activation
2092,2484,25,5,5401.62,3,2,2,7,Require Activation
2093,2485,5,5,4974.840000000001,4,2,2,8,Require Activation
2094,2486,230,2,3246.42,1,1,1,3,Require Activation
2095,2487,99,4,2978.6400000000003,1,1,1,3,Require Activation
2096,2488,19,6,6900.39,4,3,3,10,Highly potential
2097,2489,41,8,11411.16,3,4,4,11,Highly potential
2098,2491,106,5,3045.56,1,2,1,4,Needs Attention
2099,2492,8,10,12661.35,4,4,4,12,Highly potential
2100,2493,55,3,3796.09,2,1,1,4,Needs Attention
2101,2494,96,7,6744.39,1,3,3,7,Require Activation
2102,2495,32,8,5497.11,3,4,2,9,Highly potential
2103,2496,197,5,2095.52,1,2,1,4,Needs Attention
2104,2497,47,4,4265.4400000000005,2,1,2,5,Promising
2105,2498,8,8,9981.910000000002,4,4,4,12,Highly potential
2106,2499,176,3,3848.0699999999997,1,1,1,3,Require Activation
2107,2500,24,3,2535.87,3,1,1,5,Promising
2108,2501,19,7,7685.120000000001,4,3,3,10,Highly potential
2109,2502,15,5,4196.26,4,2,2,8,Require Activation
2110,2503,109,4,4951.0,1,1,2,4,Needs Attention
2111,2505,13,9,10295.31,4,4,4,12,Highly potential
2112,2507,48,4,5405.0,2,1,2,5,Promising
2113,2508,57,10,12948.97,2,4,4,10,Highly potential
2114,2509,26,8,8313.9,3,4,4,11,Highly potential
2115,2510,112,6,8315.039999999999,1,3,4,8,Require Activation
2116,2511,33,4,5381.1900000000005,3,1,2,6,Loyal
2117,2512,112,6,5536.07,1,3,2,6,Loyal
2118,2513,107,7,8203.29,1,3,4,8,Require Activation
2119,2514,47,3,4414.049999999999,2,1,2,5,Promising
2120,2516,84,3,1978.9299999999998,2,1,1,4,Needs Attention
2121,2517,146,3,4813.400000000001,1,1,2,4,Needs Attention
2122,2518,71,5,7538.469999999999,2,2,3,7,Require Activation
2123,2519,109,4,2487.2200000000003,1,1,1,3,Require Activation
2124,2520,12,5,4496.29,4,2,2,8,Require Activation
2125,2521,209,3,3422.3,1,1,1,3,Require Activation
2126,2523,15,9,8492.78,4,4,4,12,Highly potential
2127,2524,185,6,4384.97,1,3,2,6,Loyal
2128,2525,304,1,1977.36,1,1,1,3,Require Activation
2129,2526,54,6,6039.110000000001,2,3,3,8,Require Activation
2130,2527,41,7,8751.73,3,3,4,10,Highly potential
2131,2528,26,7,9485.91,3,3,4,10,Highly potential
2132,2529,99,7,9000.92,1,3,4,8,Require Activation
2133,2530,10,6,3794.98,4,3,1,8,Require Activation
2134,2531,6,7,7233.38,4,3,3,10,Highly potential
2135,2533,19,3,4689.75,4,1,2,7,Require Activation
2136,2534,46,7,8069.62,2,3,4,9,Highly potential
2137,2535,15,6,5517.49,4,3,2,9,Highly potential
2138,2536,8,6,9145.1,4,3,4,11,Highly potential
2139,2537,23,11,11743.039999999999,3,4,4,11,Highly potential
2140,2539,41,5,5493.46,3,2,2,7,Require Activation
2141,2541,21,2,3358.87,3,1,1,5,Promising
2142,2542,44,7,10741.16,3,3,4,10,Highly potential
2143,2543,23,4,5543.460000000001,3,1,2,6,Loyal
2144,2544,33,6,6633.58,3,3,3,9,Highly potential
2145,2545,118,3,2916.92,1,1,1,3,Require Activation
2146,2546,20,4,2419.01,3,1,1,5,Promising
2147,2547,185,3,2217.0600000000004,1,1,1,3,Require Activation
2148,2548,4,13,14027.079999999998,4,4,4,12,Highly potential
2149,2549,58,4,6211.0,2,1,3,6,Loyal
2150,2550,12,5,6139.76,4,2,3,9,Highly potential
2151,2551,266,4,4894.9800000000005,1,1,2,4,Needs Attention
2152,2554,60,5,4993.71,2,2,2,6,Loyal
2153,2555,2,5,7747.139999999999,4,2,3,9,Highly potential
2154,2559,13,6,3860.65,4,3,1,8,Require Activation
2155,2560,46,11,9706.619999999999,2,4,4,10,Highly potential
2156,2562,102,7,8220.23,1,3,4,8,Require Activation
2157,2563,58,5,4716.139999999999,2,2,2,6,Loyal
2158,2564,48,5,2828.34,2,2,1,5,Promising
2159,2565,30,9,11516.509999999998,3,4,4,11,Highly potential
2160,2566,18,10,8489.6,4,4,4,12,Highly potential
2161,2567,72,4,5954.21,2,1,3,6,Loyal
2162,2568,73,4,3918.87,2,1,1,4,Needs Attention
2163,2569,76,7,9585.829999999998,2,3,4,9,Highly potential
2164,2570,94,8,8168.889999999999,1,4,4,9,Highly potential
2165,2571,46,3,3652.2799999999997,2,1,1,4,Needs Attention
2166,2572,80,8,10111.810000000001,2,4,4,10,Highly potential
2167,2573,15,4,4088.91,4,1,1,6,Loyal
2168,2575,11,5,4119.530000000001,4,2,2,8,Require Activation
2169,2576,79,7,8271.03,2,3,4,9,Highly potential
2170,2577,94,6,5240.64,1,3,2,6,Loyal
2171,2578,39,4,4676.0199999999995,3,1,2,6,Loyal
2172,2579,50,3,2288.84,2,1,1,4,Needs Attention
2173,2582,53,5,5104.43,2,2,2,6,Loyal
2174,2583,93,4,4046.6200000000003,1,1,1,3,Require Activation
2175,2585,6,7,7066.380000000001,4,3,3,10,Highly potential
2176,2586,20,3,3379.79,3,1,1,5,Promising
2177,2587,65,9,9007.27,2,4,4,10,Highly potential
2178,2588,179,3,5656.6900000000005,1,1,2,4,Needs Attention
2179,2590,51,6,8720.42,2,3,4,9,Highly potential
2180,2592,38,8,11062.61,3,4,4,11,Highly potential
2181,2593,61,4,3940.2700000000004,2,1,1,4,Needs Attention
2182,2594,92,6,9467.470000000001,1,3,4,8,Require Activation
2183,2595,45,8,10273.25,3,4,4,11,Highly potential
2184,2596,73,5,7674.389999999999,2,2,3,7,Require Activation
2185,2597,6,6,7670.71,4,3,3,10,Highly potential
2186,2598,88,5,6570.66,2,2,3,7,Require Activation
2187,2599,54,6,5641.2699999999995,2,3,2,7,Require Activation
2188,2600,172,3,4973.54,1,1,2,4,Needs Attention
2189,2601,37,8,9798.03,3,4,4,11,Highly potential
2190,2602,72,8,7898.910000000001,2,4,3,9,Highly potential
2191,2603,15,7,7817.9400000000005,4,3,3,10,Highly potential
2192,2604,87,6,6086.83,2,3,3,8,Require Activation
2193,2605,116,5,6656.209999999999,1,2,3,6,Loyal
2194,2606,6,10,12338.51,4,4,4,12,Highly potential
2195,2607,6,8,7870.34,4,4,3,11,Highly potential
2196,2608,18,7,4403.82,4,3,2,9,Highly potential
2197,2609,188,7,6390.16,1,3,3,7,Require Activation
2198,2610,113,8,8499.220000000001,1,4,4,9,Highly potential
2199,2611,3,7,5700.590000000001,4,3,2,9,Highly potential
2200,2612,210,2,1924.4700000000003,1,1,1,3,Require Activation
2201,2616,43,11,13134.119999999999,3,4,4,11,Highly potential
2202,2618,8,10,9670.589999999998,4,4,4,12,Highly potential
2203,2619,77,2,3869.2699999999995,2,1,1,4,Needs Attention
2204,2620,31,8,8317.97,3,4,4,11,Highly potential
2205,2621,10,7,6926.01,4,3,3,10,Highly potential
2206,2622,17,7,6595.219999999999,4,3,3,10,Highly potential
2207,2623,11,4,5764.37,4,1,2,7,Require Activation
2208,2624,28,4,4940.76,3,1,2,6,Loyal
2209,2625,85,4,3403.67,2,1,1,4,Needs Attention
2210,2626,42,4,4263.71,3,1,2,6,Loyal
2211,2627,34,6,9321.82,3,3,4,10,Highly potential
2212,2628,174,4,4668.82,1,1,2,4,Needs Attention
2213,2629,45,6,7374.25,3,3,3,9,Highly potential
2214,2631,28,3,3539.6800000000003,3,1,1,5,Promising
2215,2634,190,3,2614.21,1,1,1,3,Require Activation
2216,2635,69,8,10781.21,2,4,4,10,Highly potential
2217,2636,31,3,3411.77,3,1,1,5,Promising
2218,2637,55,11,13895.709999999997,2,4,4,10,Highly potential
2219,2638,84,9,9133.15,2,4,4,10,Highly potential
2220,2639,32,5,7255.960000000001,3,2,3,8,Require Activation
2221,2640,68,11,11643.470000000003,2,4,4,10,Highly potential
2222,2641,12,7,6132.320000000001,4,3,3,10,Highly potential
2223,2643,55,3,1897.1999999999998,2,1,1,4,Needs Attention
2224,2644,61,2,1697.24,2,1,1,4,Needs Attention
2225,2645,33,6,5168.14,3,3,2,8,Require Activation
2226,2646,120,5,4987.72,1,2,2,5,Promising
2227,2648,36,5,6102.130000000001,3,2,3,8,Require Activation
2228,2649,130,4,6633.45,1,1,3,5,Promising
2229,2650,26,6,5688.650000000001,3,3,2,8,Require Activation
2230,2651,16,8,10121.93,4,4,4,12,Highly potential
2231,2652,24,5,7176.64,3,2,3,8,Require Activation
2232,2653,4,9,12315.999999999998,4,4,4,12,Highly potential
2233,2654,109,9,9905.2,1,4,4,9,Highly potential
2234,2655,158,6,8575.35,1,3,4,8,Require Activation
2235,2656,139,7,9051.86,1,3,4,8,Require Activation
2236,2657,183,3,3891.5,1,1,1,3,Require Activation
2237,2659,1,12,11948.479999999998,4,4,4,12,Highly potential
2238,2661,9,5,5712.01,4,2,2,8,Require Activation
2239,2662,63,9,10546.039999999999,2,4,4,10,Highly potential
2240,2663,165,5,7423.23,1,2,3,6,Loyal
2241,2664,135,7,6587.43,1,3,3,7,Require Activation
2242,2665,31,3,5364.68,3,1,2,6,Loyal
2243,2666,257,4,4534.9,1,1,2,4,Needs Attention
2244,2667,99,5,5817.66,1,2,2,5,Promising
2245,2668,62,5,3342.3,2,2,1,5,Promising
2246,2669,49,3,3552.54,2,1,1,4,Needs Attention
2247,2670,59,3,3290.6800000000003,2,1,1,4,Needs Attention
2248,2671,101,7,8811.26,1,3,4,8,Require Activation
2249,2672,16,8,8417.05,4,4,4,12,Highly potential
2250,2673,91,5,4576.389999999999,1,2,2,5,Promising
2251,2674,45,5,6395.900000000001,3,2,3,8,Require Activation
2252,2675,96,5,5429.799999999999,1,2,2,5,Promising
2253,2676,6,6,7274.78,4,3,3,10,Highly potential
2254,2678,114,5,5004.09,1,2,2,5,Promising
2255,2679,86,6,5660.3099999999995,2,3,2,7,Require Activation
2256,2680,17,9,9177.27,4,4,4,12,Highly potential
2257,2681,51,5,4606.83,2,2,2,6,Loyal
2258,2682,39,8,6122.34,3,4,3,10,Highly potential
2259,2683,17,6,7829.890000000001,4,3,3,10,Highly potential
2260,2684,39,9,11938.04,3,4,4,11,Highly potential
2261,2686,25,11,13237.880000000001,3,4,4,11,Highly potential
2262,2687,18,7,6724.2300000000005,4,3,3,10,Highly potential
2263,2688,89,3,3018.69,2,1,1,4,Needs Attention
2264,2689,2,5,3956.1800000000003,4,2,1,7,Require Activation
2265,2690,110,4,5860.55,1,1,2,4,Needs Attention
2266,2691,61,8,8562.05,2,4,4,10,Highly potential
2267,2692,41,3,1662.12,3,1,1,5,Promising
2268,2693,2,6,5128.639999999999,4,3,2,9,Highly potential
2269,2694,30,4,2766.0899999999997,3,1,1,5,Promising
2270,2695,5,8,10630.04,4,4,4,12,Highly potential
2271,2698,13,7,9054.05,4,3,4,11,Highly potential
2272,2699,61,5,3428.7599999999998,2,2,1,5,Promising
2273,2700,72,4,4497.46,2,1,2,5,Promising
2274,2701,53,9,11558.89,2,4,4,10,Highly potential
2275,2702,20,8,11698.41,3,4,4,11,Highly potential
2276,2704,236,3,1517.27,1,1,1,3,Require Activation
2277,2705,3,8,10063.400000000001,4,4,4,12,Highly potential
2278,2706,124,3,2769.3599999999997,1,1,1,3,Require Activation
2279,2707,44,3,3934.6000000000004,3,1,1,5,Promising
2280,2708,12,3,3437.0800000000004,4,1,1,6,Loyal
2281,2711,64,6,6439.08,2,3,3,8,Require Activation
2282,2712,17,6,6967.0199999999995,4,3,3,10,Highly potential
2283,2713,1,2,1722.85,4,1,1,6,Loyal
2284,2714,9,5,4081.8100000000004,4,2,1,7,Require Activation
2285,2715,105,5,6644.62,1,2,3,6,Loyal
2286,2717,42,9,9904.869999999999,3,4,4,11,Highly potential
2287,2718,222,7,6798.88,1,3,3,7,Require Activation
2288,2719,11,3,3061.49,4,1,1,6,Loyal
2289,2720,149,4,3710.1900000000005,1,1,1,3,Require Activation
2290,2723,41,8,10565.12,3,4,4,11,Highly potential
2291,2724,143,4,4604.3,1,1,2,4,Needs Attention
2292,2725,177,4,2094.38,1,1,1,3,Require Activation
2293,2726,28,9,9047.33,3,4,4,11,Highly potential
2294,2727,50,5,8567.85,2,2,4,8,Require Activation
2295,2728,8,8,9659.77,4,4,4,12,Highly potential
2296,2729,7,6,8706.470000000001,4,3,4,11,Highly potential
2297,2730,5,7,4649.51,4,3,2,9,Highly potential
2298,2731,4,4,2409.89,4,1,1,6,Loyal
2299,2732,17,9,6519.719999999999,4,4,3,11,Highly potential
2300,2733,29,9,12972.269999999997,3,4,4,11,Highly potential
2301,2735,149,2,1340.77,1,1,1,3,Require Activation
2302,2736,43,5,4311.28,3,2,2,7,Require Activation
2303,2738,60,5,5189.82,2,2,2,6,Loyal
2304,2739,243,2,743.0500000000001,1,1,1,3,Require Activation
2305,2740,27,8,10497.95,3,4,4,11,Highly potential
2306,2741,20,3,3056.2200000000003,3,1,1,5,Promising
2307,2742,96,3,3741.05,1,1,1,3,Require Activation
2308,2743,47,2,2956.8,2,1,1,4,Needs Attention
2309,2744,126,3,3148.36,1,1,1,3,Require Activation
2310,2745,268,2,3322.62,1,1,1,3,Require Activation
2311,2746,9,3,3056.2200000000003,4,1,1,6,Loyal
2312,2747,15,8,10528.31,4,4,4,12,Highly potential
2313,2748,7,4,3952.7,4,1,1,6,Loyal
2314,2749,35,1,1061.56,3,1,1,5,Promising
2315,2751,4,8,9856.480000000001,4,4,4,12,Highly potential
2316,2752,13,4,5737.59,4,1,2,7,Require Activation
2317,2753,68,11,9649.8,2,4,4,10,Highly potential
2318,2754,187,3,5568.64,1,1,2,4,Needs Attention
2319,2755,29,11,10018.130000000001,3,4,4,11,Highly potential
2320,2759,111,5,5619.73,1,2,2,5,Promising
2321,2760,32,4,4168.87,3,1,2,6,Loyal
2322,2761,8,9,10079.419999999998,4,4,4,12,Highly potential
2323,2763,20,9,6496.639999999999,3,4,3,10,Highly potential
2324,2766,48,6,8740.06,2,3,4,9,Highly potential
2325,2767,49,3,2597.41,2,1,1,4,Needs Attention
2326,2768,24,6,6811.9400000000005,3,3,3,9,Highly potential
2327,2769,47,6,8004.25,2,3,3,8,Require Activation
2328,2770,31,9,13728.699999999999,3,4,4,11,Highly potential
2329,2771,45,5,8579.48,3,2,4,9,Highly potential
2330,2772,26,5,5138.68,3,2,2,7,Require Activation
2331,2773,5,4,4179.19,4,1,2,7,Require Activation
2332,2775,13,6,6201.93,4,3,3,10,Highly potential
2333,2777,104,6,6216.71,1,3,3,7,Require Activation
2334,2778,10,5,5669.9,4,2,2,8,Require Activation
2335,2780,3,5,6150.43,4,2,3,9,Highly potential
2336,2781,74,4,4131.86,2,1,2,5,Promising
2337,2782,171,5,4995.43,1,2,2,5,Promising
2338,2783,74,11,9019.439999999999,2,4,4,10,Highly potential
2339,2784,75,3,2423.2200000000003,2,1,1,4,Needs Attention
2340,2785,46,6,9232.949999999999,2,3,4,9,Highly potential
2341,2786,4,6,4372.299999999999,4,3,2,9,Highly potential
2342,2787,38,6,10014.36,3,3,4,10,Highly potential
2343,2788,45,11,17258.94,3,4,4,11,Highly potential
2344,2789,25,2,2097.73,3,1,1,5,Promising
2345,2790,78,3,1799.14,2,1,1,4,Needs Attention
2346,2791,15,6,8909.15,4,3,4,11,Highly potential
2347,2792,219,3,4771.39,1,1,2,4,Needs Attention
2348,2793,35,7,9763.37,3,3,4,10,Highly potential
2349,2794,6,7,7835.25,4,3,3,10,Highly potential
2350,2795,226,2,2369.69,1,1,1,3,Require Activation
2351,2796,9,7,8157.719999999999,4,3,4,11,Highly potential
2352,2798,155,5,3433.4699999999993,1,2,1,4,Needs Attention
2353,2799,30,8,9916.089999999998,3,4,4,11,Highly potential
2354,2800,42,5,1193.9,3,2,1,6,Loyal
2355,2802,173,3,1370.06,1,1,1,3,Require Activation
2356,2803,31,6,6522.640000000001,3,3,3,9,Highly potential
2357,2804,59,7,6016.75,2,3,3,8,Require Activation
2358,2806,69,8,8667.06,2,4,4,10,Highly potential
2359,2807,354,1,1216.14,1,1,1,3,Require Activation
2360,2808,7,5,6828.290000000001,4,2,3,9,Highly potential
2361,2809,84,3,2490.58,2,1,1,4,Needs Attention
2362,2811,26,5,4456.35,3,2,2,7,Require Activation
2363,2812,88,6,8956.25,2,3,4,9,Highly potential
2364,2813,205,4,4560.26,1,1,2,4,Needs Attention
2365,2814,14,4,4851.34,4,1,2,7,Require Activation
2366,2816,9,10,13562.73,4,4,4,12,Highly potential
2367,2817,16,3,4046.6099999999997,4,1,1,6,Loyal
2368,2818,100,4,5234.29,1,1,2,4,Needs Attention
2369,2819,163,4,5543.0199999999995,1,1,2,4,Needs Attention
2370,2820,59,7,8152.689999999999,2,3,4,9,Highly potential
2371,2821,52,5,4455.08,2,2,2,6,Loyal
2372,2822,12,8,8230.66,4,4,4,12,Highly potential
2373,2823,13,4,2040.6100000000001,4,1,1,6,Loyal
2374,2824,123,6,8837.81,1,3,4,8,Require Activation
2375,2825,113,4,4231.89,1,1,2,4,Needs Attention
2376,2826,12,12,11244.57,4,4,4,12,Highly potential
2377,2829,145,2,3023.32,1,1,1,3,Require Activation
2378,2830,96,5,4885.5199999999995,1,2,2,5,Promising
2379,2831,15,5,4904.01,4,2,2,8,Require Activation
2380,2832,24,8,6485.339999999999,3,4,3,10,Highly potential
2381,2836,14,9,10868.1,4,4,4,12,Highly potential
2382,2838,16,3,2838.62,4,1,1,6,Loyal
2383,2839,18,8,7971.99,4,4,3,11,Highly potential
2384,2840,17,4,3362.7599999999998,4,1,1,6,Loyal
2385,2841,17,7,10658.349999999999,4,3,4,11,Highly potential
2386,2843,21,6,6116.000000000001,3,3,3,9,Highly potential
2387,2845,48,8,8539.210000000001,2,4,4,10,Highly potential
2388,2846,16,3,2298.78,4,1,1,6,Loyal
2389,2847,45,7,8251.07,3,3,4,10,Highly potential
2390,2848,14,4,5354.43,4,1,2,7,Require Activation
2391,2850,8,8,7671.88,4,4,3,11,Highly potential
2392,2851,10,8,8746.78,4,4,4,12,Highly potential
2393,2852,26,6,8373.67,3,3,4,10,Highly potential
2394,2853,82,8,8836.36,2,4,4,10,Highly potential
2395,2855,40,2,255.35000000000002,3,1,1,5,Promising
2396,2856,7,7,10139.11,4,3,4,11,Highly potential
2397,2857,114,6,8974.25,1,3,4,8,Require Activation
2398,2858,109,4,6672.9400000000005,1,1,3,5,Promising
2399,2859,11,8,6793.5599999999995,4,4,3,11,Highly potential
2400,2860,9,9,13804.79,4,4,4,12,Highly potential
2401,2861,74,8,9484.25,2,4,4,10,Highly potential
2402,2862,15,5,4816.96,4,2,2,8,Require Activation
2403,2863,176,1,544.05,1,1,1,3,Require Activation
2404,2864,18,4,4770.77,4,1,2,7,Require Activation
2405,2865,1,7,11030.02,4,3,4,11,Highly potential
2406,2867,96,5,2866.46,1,2,1,4,Needs Attention
2407,2868,26,4,3572.7300000000005,3,1,1,5,Promising
2408,2871,21,6,4852.74,3,3,2,8,Require Activation
2409,2872,25,7,7041.06,3,3,3,9,Highly potential
2410,2873,105,3,3244.63,1,1,1,3,Require Activation
2411,2874,61,11,15091.910000000002,2,4,4,10,Highly potential
2412,2875,36,4,5883.47,3,1,2,6,Loyal
2413,2877,42,9,8291.58,3,4,4,11,Highly potential
2414,2878,1,3,2319.39,4,1,1,6,Loyal
2415,2879,15,8,9983.98,4,4,4,12,Highly potential
2416,2880,19,8,12780.52,4,4,4,12,Highly potential
2417,2881,73,6,6506.51,2,3,3,8,Require Activation
2418,2882,295,2,2515.6800000000003,1,1,1,3,Require Activation
2419,2883,50,7,10571.82,2,3,4,9,Highly potential
2420,2884,15,8,6897.469999999999,4,4,3,11,Highly potential
2421,2885,95,9,12055.64,1,4,4,9,Highly potential
2422,2886,40,8,8504.949999999999,3,4,4,11,Highly potential
2423,2887,25,9,10892.99,3,4,4,11,Highly potential
2424,2888,30,6,7967.07,3,3,3,9,Highly potential
2425,2889,106,5,6098.48,1,2,3,6,Loyal
2426,2890,87,7,8037.32,2,3,4,9,Highly potential
2427,2891,63,7,8583.39,2,3,4,9,Highly potential
2428,2892,13,5,6697.78,4,2,3,9,Highly potential
2429,2893,60,3,4825.25,2,1,2,5,Promising
2430,2895,259,2,1390.68,1,1,1,3,Require Activation
2431,2896,195,2,2648.5,1,1,1,3,Require Activation
2432,2897,47,5,4416.799999999999,2,2,2,6,Loyal
2433,2898,79,4,4284.3099999999995,2,1,2,5,Promising
2434,2899,31,6,6188.15,3,3,3,9,Highly potential
2435,2900,62,3,4234.34,2,1,2,5,Promising
2436,2902,197,2,1591.08,1,1,1,3,Require Activation
2437,2903,27,3,3175.6200000000003,3,1,1,5,Promising
2438,2904,24,7,5397.49,3,3,2,8,Require Activation
2439,2905,9,4,3343.6899999999996,4,1,1,6,Loyal
2440,2906,46,4,4835.93,2,1,2,5,Promising
2441,2908,2,6,3638.1799999999994,4,3,1,8,Require Activation
2442,2909,84,7,7868.9,2,3,3,8,Require Activation
2443,2910,88,7,4188.58,2,3,2,7,Require Activation
2444,2911,284,2,1875.15,1,1,1,3,Require Activation
2445,2913,90,6,5130.110000000001,1,3,2,6,Loyal
2446,2914,13,12,13824.53,4,4,4,12,Highly potential
2447,2915,34,7,6896.26,3,3,3,9,Highly potential
2448,2916,25,7,8475.590000000002,3,3,4,10,Highly potential
2449,2922,2,5,5507.0199999999995,4,2,2,8,Require Activation
2450,2923,14,7,6413.179999999999,4,3,3,10,Highly potential
2451,2924,65,6,5940.1900000000005,2,3,3,8,Require Activation
2452,2925,94,5,4419.8099999999995,1,2,2,5,Promising
2453,2926,144,4,3211.6899999999996,1,1,1,3,Require Activation
2454,2927,100,3,4096.320000000001,1,1,1,3,Require Activation
2455,2928,176,5,6092.18,1,2,3,6,Loyal
2456,2929,2,9,10903.630000000001,4,4,4,12,Highly potential
2457,2930,72,6,5079.0,2,3,2,7,Require Activation
2458,2931,58,6,4741.5999999999985,2,3,2,7,Require Activation
2459,2932,20,10,10991.139999999998,3,4,4,11,Highly potential
2460,2933,96,5,4806.32,1,2,2,5,Promising
2461,2934,62,6,7094.71,2,3,3,8,Require Activation
2462,2936,60,7,10669.63,2,3,4,9,Highly potential
2463,2937,8,7,11473.75,4,3,4,11,Highly potential
2464,2938,126,5,7013.27,1,2,3,6,Loyal
2465,2939,91,4,3757.8,1,1,1,3,Require Activation
2466,2940,95,7,6758.78,1,3,3,7,Require Activation
2467,2942,10,8,9837.369999999999,4,4,4,12,Highly potential
2468,2944,31,6,4572.33,3,3,2,8,Require Activation
2469,2948,112,5,4758.83,1,2,2,5,Promising
2470,2950,76,3,1953.15,2,1,1,4,Needs Attention
2471,2951,86,9,11002.56,2,4,4,10,Highly potential
2472,2952,28,5,6242.100000000001,3,2,3,8,Require Activation
2473,2953,76,5,6263.34,2,2,3,7,Require Activation
2474,2954,7,5,4688.92,4,2,2,8,Require Activation
2475,2955,20,8,8309.33,3,4,4,11,Highly potential
2476,2956,98,7,5810.69,1,3,2,6,Loyal
2477,2957,99,3,3938.5699999999997,1,1,1,3,Require Activation
2478,2958,5,6,5472.64,4,3,2,9,Highly potential
2479,2959,135,3,3525.57,1,1,1,3,Require Activation
2480,2960,89,3,5056.1,2,1,2,5,Promising
2481,2961,3,6,8983.52,4,3,4,11,Highly potential
2482,2962,78,3,2837.74,2,1,1,4,Needs Attention
2483,2964,169,2,3630.46,1,1,1,3,Require Activation
2484,2966,33,5,5009.32,3,2,2,7,Require Activation
2485,2967,11,3,4699.01,4,1,2,7,Require Activation
2486,2968,172,7,5052.9,1,3,2,6,Loyal
2487,2969,12,6,6455.64,4,3,3,10,Highly potential
2488,2970,99,4,4043.88,1,1,1,3,Require Activation
2489,2971,28,3,2449.96,3,1,1,5,Promising
2490,2973,94,4,3872.7299999999996,1,1,1,3,Require Activation
2491,2974,160,2,1166.79,1,1,1,3,Require Activation
2492,2975,170,3,4429.83,1,1,2,4,Needs Attention
2493,2976,7,4,6239.150000000001,4,1,3,8,Require Activation
2494,2977,10,5,5552.88,4,2,2,8,Require Activation
2495,2978,148,3,2701.22,1,1,1,3,Require Activation
2496,2979,115,4,3936.52,1,1,1,3,Require Activation
2497,2980,16,6,7498.77,4,3,3,10,Highly potential
2498,2981,53,6,3001.2799999999997,2,3,1,6,Loyal
2499,2982,118,7,8987.33,1,3,4,8,Require Activation
2500,2983,130,5,7256.570000000001,1,2,3,6,Loyal
2501,2984,159,4,6016.24,1,1,3,5,Promising
2502,2985,39,10,10664.07,3,4,4,11,Highly potential
2503,2987,53,4,4102.19,2,1,1,4,Needs Attention
2504,2988,33,8,8349.34,3,4,4,11,Highly potential
2505,2990,15,7,5394.23,4,3,2,9,Highly potential
2506,2991,76,6,5559.9800000000005,2,3,2,7,Require Activation
2507,2992,10,8,10530.96,4,4,4,12,Highly potential
2508,2993,10,8,11450.73,4,4,4,12,Highly potential
2509,2994,16,3,719.38,4,1,1,6,Loyal
2510,2996,22,3,4774.51,3,1,2,6,Loyal
2511,2997,32,6,5293.91,3,3,2,8,Require Activation
2512,2998,67,3,4629.21,2,1,2,5,Promising
2513,3000,43,4,4848.29,3,1,2,6,Loyal
2514,3001,105,4,4664.799999999999,1,1,2,4,Needs Attention
2515,3002,45,6,5117.81,3,3,2,8,Require Activation
2516,3003,112,9,7885.54,1,4,3,8,Require Activation
2517,3004,114,5,5048.79,1,2,2,5,Promising
2518,3005,190,3,3682.5499999999997,1,1,1,3,Require Activation
2519,3007,4,7,8547.34,4,3,4,11,Highly potential
2520,3011,36,4,3080.8,3,1,1,5,Promising
2521,3013,5,9,8161.56,4,4,4,12,Highly potential
2522,3014,20,9,8691.039999999999,3,4,4,11,Highly potential
2523,3015,47,9,13737.05,2,4,4,10,Highly potential
2524,3016,1,5,7991.99,4,2,3,9,Highly potential
2525,3017,177,4,5289.49,1,1,2,4,Needs Attention
2526,3018,20,5,3833.350000000001,3,2,1,6,Loyal
2527,3019,65,3,4258.98,2,1,2,5,Promising
2528,3020,23,11,10879.600000000002,3,4,4,11,Highly potential
2529,3023,133,4,2119.85,1,1,1,3,Require Activation
2530,3025,126,2,2263.49,1,1,1,3,Require Activation
2531,3026,93,5,4489.49,1,2,2,5,Promising
2532,3027,32,5,3296.91,3,2,1,6,Loyal
2533,3028,54,4,5030.69,2,1,2,5,Promising
2534,3029,122,4,5099.51,1,1,2,4,Needs Attention
2535,3030,25,7,5700.4,3,3,2,8,Require Activation
2536,3031,3,5,6455.51,4,2,3,9,Highly potential
2537,3032,41,7,10767.019999999999,3,3,4,10,Highly potential
2538,3033,159,2,2523.2,1,1,1,3,Require Activation
2539,3034,49,5,5496.759999999999,2,2,2,6,Loyal
2540,3035,39,5,4522.24,3,2,2,7,Require Activation
2541,3036,157,5,8620.529999999999,1,2,4,7,Require Activation
2542,3037,186,3,2449.3,1,1,1,3,Require Activation
2543,3040,346,1,2091.47,1,1,1,3,Require Activation
2544,3041,125,2,3469.37,1,1,1,3,Require Activation
2545,3042,12,6,6916.03,4,3,3,10,Highly potential
2546,3043,12,4,4497.96,4,1,2,7,Require Activation
2547,3044,5,9,10768.18,4,4,4,12,Highly potential
2548,3045,66,5,6795.040000000001,2,2,3,7,Require Activation
2549,3046,229,4,5855.92,1,1,2,4,Needs Attention
2550,3047,35,5,6712.389999999999,3,2,3,8,Require Activation
2551,3048,5,12,13272.89,4,4,4,12,Highly potential
2552,3054,3,5,7022.29,4,2,3,9,Highly potential
2553,3055,59,10,10643.23,2,4,4,10,Highly potential
2554,3056,20,4,4165.67,3,1,2,6,Loyal
2555,3057,29,7,9733.550000000001,3,3,4,10,Highly potential
2556,3058,25,5,8188.64,3,2,4,9,Highly potential
2557,3059,143,2,3898.92,1,1,1,3,Require Activation
2558,3060,30,11,14609.22,3,4,4,11,Highly potential
2559,3061,60,9,8604.589999999998,2,4,4,10,Highly potential
2560,3062,47,6,6083.87,2,3,3,8,Require Activation
2561,3063,93,4,1240.62,1,1,1,3,Require Activation
2562,3064,56,7,6989.68,2,3,3,8,Require Activation
2563,3065,6,5,5665.26,4,2,2,8,Require Activation
2564,3066,165,4,3756.25,1,1,1,3,Require Activation
2565,3067,40,6,7095.87,3,3,3,9,Highly potential
2566,3068,80,6,5197.79,2,3,2,7,Require Activation
2567,3069,71,3,3104.7999999999997,2,1,1,4,Needs Attention
2568,3070,120,4,1927.42,1,1,1,3,Require Activation
2569,3071,159,4,3954.99,1,1,1,3,Require Activation
2570,3072,68,7,7712.87,2,3,3,8,Require Activation
2571,3073,252,3,3426.9500000000003,1,1,1,3,Require Activation
2572,3074,11,7,8822.949999999999,4,3,4,11,Highly potential
2573,3076,210,4,4105.89,1,1,1,3,Require Activation
2574,3077,17,7,8452.62,4,3,4,11,Highly potential
2575,3078,170,3,2490.95,1,1,1,3,Require Activation
2576,3079,132,4,4030.71,1,1,1,3,Require Activation
2577,3080,5,9,10388.830000000002,4,4,4,12,Highly potential
2578,3081,107,6,8311.18,1,3,4,8,Require Activation
2579,3084,16,6,7652.58,4,3,3,10,Highly potential
2580,3085,26,4,3400.5800000000004,3,1,1,5,Promising
2581,3087,85,6,6584.209999999999,2,3,3,8,Require Activation
2582,3089,28,4,6196.130000000001,3,1,3,7,Require Activation
2583,3090,199,5,6006.22,1,2,3,6,Loyal
2584,3091,308,2,1434.48,1,1,1,3,Require Activation
2585,3092,161,3,3324.14,1,1,1,3,Require Activation
2586,3093,69,9,10362.369999999999,2,4,4,10,Highly potential
2587,3094,162,7,6633.12,1,3,3,7,Require Activation
2588,3096,16,3,5023.0599999999995,4,1,2,7,Require Activation
2589,3097,61,3,3076.92,2,1,1,4,Needs Attention
2590,3098,39,4,5235.47,3,1,2,6,Loyal
2591,3100,21,4,5579.870000000001,3,1,2,6,Loyal
2592,3101,62,3,3983.01,2,1,1,4,Needs Attention
2593,3102,107,4,6100.75,1,1,3,5,Promising
2594,3103,60,8,9084.18,2,4,4,10,Highly potential
2595,3104,50,5,5021.03,2,2,2,6,Loyal
2596,3105,11,6,6820.6,4,3,3,10,Highly potential
2597,3107,96,3,3819.28,1,1,1,3,Require Activation
2598,3108,54,7,10194.97,2,3,4,9,Highly potential
2599,3109,170,5,6150.85,1,2,3,6,Loyal
2600,3110,18,3,2064.7700000000004,4,1,1,6,Loyal
2601,3111,49,4,3370.16,2,1,1,4,Needs Attention
2602,3112,12,8,8006.59,4,4,3,11,Highly potential
2603,3113,110,8,10192.61,1,4,4,9,Highly potential
2604,3114,4,4,5115.57,4,1,2,7,Require Activation
2605,3115,196,5,6326.07,1,2,3,6,Loyal
2606,3117,26,9,12615.479999999998,3,4,4,11,Highly potential
2607,3118,13,9,14065.030000000002,4,4,4,12,Highly potential
2608,3120,21,7,7351.700000000001,3,3,3,9,Highly potential
2609,3121,49,6,6379.44,2,3,3,8,Require Activation
2610,3123,1,4,3733.7200000000003,4,1,1,6,Loyal
2611,3124,39,3,2085.1800000000003,3,1,1,5,Promising
2612,3125,10,4,4529.16,4,1,2,7,Require Activation
2613,3126,41,8,9426.93,3,4,4,11,Highly potential
2614,3127,36,4,5836.78,3,1,2,6,Loyal
2615,3128,105,5,5753.62,1,2,2,5,Promising
2616,3129,17,5,6405.030000000001,4,2,3,9,Highly potential
2617,3130,1,5,6539.6,4,2,3,9,Highly potential
2618,3132,24,5,5502.290000000001,3,2,2,7,Require Activation
2619,3133,12,6,7335.610000000001,4,3,3,10,Highly potential
2620,3135,122,7,7539.8099999999995,1,3,3,7,Require Activation
2621,3136,26,4,4905.759999999999,3,1,2,6,Loyal
2622,3138,70,4,5084.3,2,1,2,5,Promising
2623,3139,12,3,2633.05,4,1,1,6,Loyal
2624,3140,41,3,2714.79,3,1,1,5,Promising
2625,3141,71,7,3596.67,2,3,1,6,Loyal
2626,3142,13,4,4004.87,4,1,1,6,Loyal
2627,3143,21,11,10532.28,3,4,4,11,Highly potential
2628,3144,65,3,1975.27,2,1,1,4,Needs Attention
2629,3145,69,6,7219.03,2,3,3,8,Require Activation
2630,3146,55,8,11006.289999999999,2,4,4,10,Highly potential
2631,3148,56,6,6033.4,2,3,3,8,Require Activation
2632,3149,23,3,3636.56,3,1,1,5,Promising
2633,3150,88,7,3787.1800000000003,2,3,1,6,Loyal
2634,3152,12,6,5683.7300000000005,4,3,2,9,Highly potential
2635,3153,128,5,8533.27,1,2,4,7,Require Activation
2636,3154,15,7,6780.46,4,3,3,10,Highly potential
2637,3155,44,4,2692.74,3,1,1,5,Promising
2638,3158,17,6,7721.6900000000005,4,3,3,10,Highly potential
2639,3160,53,4,5296.11,2,1,2,5,Promising
2640,3162,111,2,2734.17,1,1,1,3,Require Activation
2641,3163,15,6,5066.64,4,3,2,9,Highly potential
2642,3164,99,5,6151.660000000001,1,2,3,6,Loyal
2643,3165,78,8,8775.91,2,4,4,10,Highly potential
2644,3166,48,7,9906.009999999998,2,3,4,9,Highly potential
2645,3167,74,3,3266.8,2,1,1,4,Needs Attention
2646,3168,92,4,6708.369999999999,1,1,3,5,Promising
2647,3169,1,7,6806.929999999999,4,3,3,10,Highly potential
2648,3170,45,6,6884.95,3,3,3,9,Highly potential
2649,3174,25,6,4986.21,3,3,2,8,Require Activation
2650,3175,261,3,3044.7200000000003,1,1,1,3,Require Activation
2651,3176,25,9,7167.2699999999995,3,4,3,10,Highly potential
2652,3177,69,6,4811.719999999999,2,3,2,7,Require Activation
2653,3178,30,5,6357.4800000000005,3,2,3,8,Require Activation
2654,3179,269,1,1148.64,1,1,1,3,Require Activation
2655,3181,10,6,8160.14,4,3,4,11,Highly potential
2656,3183,12,8,6607.7699999999995,4,4,3,11,Highly potential
2657,3184,69,8,9258.6,2,4,4,10,Highly potential
2658,3185,19,7,6809.119999999999,4,3,3,10,Highly potential
2659,3187,64,5,5489.099999999999,2,2,2,6,Loyal
2660,3189,57,2,200.7,2,1,1,4,Needs Attention
2661,3191,8,8,9402.43,4,4,4,12,Highly potential
2662,3192,189,4,4871.5199999999995,1,1,2,4,Needs Attention
2663,3193,11,6,5155.41,4,3,2,9,Highly potential
2664,3194,87,3,3691.67,2,1,1,4,Needs Attention
2665,3195,50,8,7261.0,2,4,3,9,Highly potential
2666,3196,51,7,7505.92,2,3,3,8,Require Activation
2667,3197,4,5,5284.57,4,2,2,8,Require Activation
2668,3198,102,4,5693.18,1,1,2,4,Needs Attention
2669,3199,14,8,10703.79,4,4,4,12,Highly potential
2670,3201,22,7,7757.7300000000005,3,3,3,9,Highly potential
2671,3202,12,8,9341.0,4,4,4,12,Highly potential
2672,3203,8,3,4714.8099999999995,4,1,2,7,Require Activation
2673,3204,35,9,12368.289999999999,3,4,4,11,Highly potential
2674,3205,97,6,6054.93,1,3,3,7,Require Activation
2675,3206,76,7,7842.210000000001,2,3,3,8,Require Activation
2676,3208,54,8,9638.46,2,4,4,10,Highly potential
2677,3209,10,4,3112.4300000000003,4,1,1,6,Loyal
2678,3210,10,5,3992.0599999999995,4,2,1,7,Require Activation
2679,3211,36,3,3667.73,3,1,1,5,Promising
2680,3212,100,7,12326.749999999998,1,3,4,8,Require Activation
2681,3214,69,4,4838.349999999999,2,1,2,5,Promising
2682,3215,67,7,11950.24,2,3,4,9,Highly potential
2683,3216,1,4,3366.82,4,1,1,6,Loyal
2684,3217,9,11,10733.560000000001,4,4,4,12,Highly potential
2685,3218,217,5,4886.1,1,2,2,5,Promising
2686,3219,28,8,7191.65,3,4,3,10,Highly potential
2687,3220,41,8,7616.300000000001,3,4,3,10,Highly potential
2688,3221,112,9,11096.319999999998,1,4,4,9,Highly potential
2689,3224,52,9,8518.72,2,4,4,10,Highly potential
2690,3225,9,7,7505.339999999999,4,3,3,10,Highly potential
2691,3228,41,7,9815.410000000002,3,3,4,10,Highly potential
2692,3230,70,5,5698.38,2,2,2,6,Loyal
2693,3232,9,13,13451.28,4,4,4,12,Highly potential
2694,3233,81,3,2477.0699999999997,2,1,1,4,Needs Attention
2695,3234,150,2,2358.0,1,1,1,3,Require Activation
2696,3235,223,1,1163.89,1,1,1,3,Require Activation
2697,3237,177,7,8413.77,1,3,4,8,Require Activation
2698,3238,30,5,3916.4400000000005,3,2,1,6,Loyal
2699,3239,3,6,4374.750000000001,4,3,2,9,Highly potential
2700,3240,39,10,12357.57,3,4,4,11,Highly potential
2701,3241,8,6,9227.58,4,3,4,11,Highly potential
2702,3242,50,7,10813.44,2,3,4,9,Highly potential
2703,3243,164,4,4005.26,1,1,1,3,Require Activation
2704,3244,22,4,3578.91,3,1,1,5,Promising
2705,3245,94,6,5577.43,1,3,2,6,Loyal
2706,3246,100,5,6186.95,1,2,3,6,Loyal
2707,3247,45,8,7108.270000000001,3,4,3,10,Highly potential
2708,3248,59,4,3305.23,2,1,1,4,Needs Attention
2709,3249,34,7,10781.65,3,3,4,10,Highly potential
2710,3251,8,11,9947.98,4,4,4,12,Highly potential
2711,3252,19,7,5910.41,4,3,3,10,Highly potential
2712,3253,6,3,4743.31,4,1,2,7,Require Activation
2713,3254,32,6,6956.21,3,3,3,9,Highly potential
2714,3256,13,10,12399.54,4,4,4,12,Highly potential
2715,3257,7,3,5121.28,4,1,2,7,Require Activation
2716,3258,18,8,11196.130000000001,4,4,4,12,Highly potential
2717,3260,125,3,3833.56,1,1,1,3,Require Activation
2718,3262,2,10,9899.640000000001,4,4,4,12,Highly potential
2719,3263,24,5,4721.62,3,2,2,7,Require Activation
2720,3265,89,7,3458.83,2,3,1,6,Loyal
2721,3266,72,7,6947.209999999998,2,3,3,8,Require Activation
2722,3268,133,6,8610.779999999999,1,3,4,8,Require Activation
2723,3269,36,4,4857.44,3,1,2,6,Loyal
2724,3270,123,5,7135.8099999999995,1,2,3,6,Loyal
2725,3271,91,4,3156.63,1,1,1,3,Require Activation
2726,3272,296,1,569.56,1,1,1,3,Require Activation
2727,3273,66,7,10472.259999999998,2,3,4,9,Highly potential
2728,3275,5,4,2826.83,4,1,1,6,Loyal
2729,3276,81,5,6419.18,2,2,3,7,Require Activation
2730,3277,38,5,5868.16,3,2,2,7,Require Activation
2731,3278,23,5,5194.070000000001,3,2,2,7,Require Activation
2732,3279,298,1,1071.23,1,1,1,3,Require Activation
2733,3280,135,8,11763.690000000002,1,4,4,9,Highly potential
2734,3281,60,2,2044.08,2,1,1,4,Needs Attention
2735,3282,17,4,4534.849999999999,4,1,2,7,Require Activation
2736,3283,45,6,7803.8,3,3,3,9,Highly potential
2737,3284,279,6,5886.76,1,3,2,6,Loyal
2738,3285,20,6,6515.55,3,3,3,9,Highly potential
2739,3286,10,11,11050.25,4,4,4,12,Highly potential
2740,3287,77,3,3694.7200000000003,2,1,1,4,Needs Attention
2741,3289,70,5,7683.389999999999,2,2,3,7,Require Activation
2742,3291,47,4,3946.95,2,1,1,4,Needs Attention
2743,3292,302,1,60.34,1,1,1,3,Require Activation
2744,3293,1,5,4716.33,4,2,2,8,Require Activation
2745,3294,63,4,6769.75,2,1,3,6,Loyal
2746,3295,20,8,10279.810000000001,3,4,4,11,Highly potential
2747,3296,65,11,8887.000000000002,2,4,4,10,Highly potential
2748,3297,59,6,4162.96,2,3,2,7,Require Activation
2749,3299,31,5,4560.97,3,2,2,7,Require Activation
2750,3300,16,6,8221.25,4,3,4,11,Highly potential
2751,3301,43,5,4630.47,3,2,2,7,Require Activation
2752,3302,21,4,2141.3599999999997,3,1,1,5,Promising
2753,3303,21,5,4834.349999999999,3,2,2,7,Require Activation
2754,3305,40,2,306.78999999999996,3,1,1,5,Promising
2755,3306,41,5,6945.6,3,2,3,8,Require Activation
2756,3307,17,5,6066.910000000001,4,2,3,9,Highly potential
2757,3308,68,3,3436.83,2,1,1,4,Needs Attention
2758,3309,25,5,5485.790000000001,3,2,2,7,Require Activation
2759,3310,52,5,5062.860000000001,2,2,2,6,Loyal
2760,3311,66,4,3921.4900000000002,2,1,1,4,Needs Attention
2761,3315,2,7,8032.11,4,3,4,11,Highly potential
2762,3316,21,2,2608.09,3,1,1,5,Promising
2763,3317,88,4,3299.45,2,1,1,4,Needs Attention
2764,3320,138,10,10109.980000000001,1,4,4,9,Highly potential
2765,3323,191,3,4290.13,1,1,2,4,Needs Attention
2766,3326,30,13,14078.19,3,4,4,11,Highly potential
2767,3327,57,7,5776.01,2,3,2,7,Require Activation
2768,3328,41,4,3511.62,3,1,1,5,Promising
2769,3331,37,5,7702.42,3,2,3,8,Require Activation
2770,3332,6,6,6577.57,4,3,3,10,Highly potential
2771,3333,192,5,5296.389999999999,1,2,2,5,Promising
2772,3334,74,8,5742.35,2,4,2,8,Require Activation
2773,3335,4,6,4498.030000000001,4,3,2,9,Highly potential
2774,3336,75,6,9153.339999999998,2,3,4,9,Highly potential
2775,3339,39,5,4095.33,3,2,1,6,Loyal
2776,3340,114,6,6462.47,1,3,3,7,Require Activation
2777,3341,50,4,3646.81,2,1,1,4,Needs Attention
2778,3344,11,7,6236.960000000001,4,3,3,10,Highly potential
2779,3346,49,3,2794.14,2,1,1,4,Needs Attention
2780,3348,130,3,2749.69,1,1,1,3,Require Activation
2781,3349,222,5,6639.07,1,2,3,6,Loyal
2782,3350,39,6,9352.56,3,3,4,10,Highly potential
2783,3351,40,6,7191.88,3,3,3,9,Highly potential
2784,3352,38,6,5357.0199999999995,3,3,2,8,Require Activation
2785,3353,31,7,5270.16,3,3,2,8,Require Activation
2786,3355,1,5,5543.530000000001,4,2,2,8,Require Activation
2787,3356,5,5,6281.6900000000005,4,2,3,9,Highly potential
2788,3357,36,4,3897.31,3,1,1,5,Promising
2789,3358,38,6,7750.179999999999,3,3,3,9,Highly potential
2790,3359,98,4,2920.95,1,1,1,3,Require Activation
2791,3360,58,8,6162.1900000000005,2,4,3,9,Highly potential
2792,3361,45,6,8548.95,3,3,4,10,Highly potential
2793,3362,87,3,1983.8400000000001,2,1,1,4,Needs Attention
2794,3363,5,6,6443.929999999999,4,3,3,10,Highly potential
2795,3366,45,4,4591.95,3,1,2,6,Loyal
2796,3367,83,6,8647.67,2,3,4,9,Highly potential
2797,3368,30,5,5971.18,3,2,3,8,Require Activation
2798,3369,77,6,6850.6900000000005,2,3,3,8,Require Activation
2799,3370,43,6,6721.32,3,3,3,9,Highly potential
2800,3371,42,9,8400.31,3,4,4,11,Highly potential
2801,3373,45,5,6773.370000000001,3,2,3,8,Require Activation
2802,3374,2,4,6246.4400000000005,4,1,3,8,Require Activation
2803,3375,13,8,8710.18,4,4,4,12,Highly potential
2804,3379,21,6,8165.429999999999,3,3,4,10,Highly potential
2805,3380,64,5,6088.51,2,2,3,7,Require Activation
2806,3381,196,5,7129.370000000001,1,2,3,6,Loyal
2807,3382,20,10,10347.490000000002,3,4,4,11,Highly potential
2808,3383,30,5,6055.67,3,2,3,8,Require Activation
2809,3386,8,4,3908.1100000000006,4,1,1,6,Loyal
2810,3387,83,8,10309.67,2,4,4,10,Highly potential
2811,3388,104,7,8811.73,1,3,4,8,Require Activation
2812,3389,55,6,6107.860000000001,2,3,3,8,Require Activation
2813,3392,75,1,574.64,2,1,1,4,Needs Attention
2814,3393,3,5,4896.490000000001,4,2,2,8,Require Activation
2815,3394,20,5,5926.59,3,2,3,8,Require Activation
2816,3396,72,2,586.65,2,1,1,4,Needs Attention
2817,3399,38,4,5815.25,3,1,2,6,Loyal
2818,3400,27,4,2797.13,3,1,1,5,Promising
2819,3402,13,9,10700.789999999999,4,4,4,12,Highly potential
2820,3403,134,4,4516.0199999999995,1,1,2,4,Needs Attention
2821,3404,52,5,5162.17,2,2,2,6,Loyal
2822,3405,53,9,9157.710000000001,2,4,4,10,Highly potential
2823,3406,47,10,12169.87,2,4,4,10,Highly potential
2824,3407,19,7,7901.579999999999,4,3,3,10,Highly potential
2825,3408,23,5,4452.78,3,2,2,7,Require Activation
2826,3409,74,7,7353.55,2,3,3,8,Require Activation
2827,3411,31,7,11320.220000000001,3,3,4,10,Highly potential
2828,3412,45,3,4328.72,3,1,2,6,Loyal
2829,3413,26,4,6325.24,3,1,3,7,Require Activation
2830,3414,163,3,4674.02,1,1,2,4,Needs Attention
2831,3415,103,5,7794.34,1,2,3,6,Loyal
2832,3417,96,8,8566.05,1,4,4,9,Highly potential
2833,3418,91,5,4643.87,1,2,2,5,Promising
2834,3419,6,3,4108.62,4,1,1,6,Loyal
2835,3420,6,11,13885.45,4,4,4,12,Highly potential
2836,3421,29,9,11268.79,3,4,4,11,Highly potential
2837,3422,33,5,5634.9800000000005,3,2,2,7,Require Activation
2838,3423,78,4,3061.5,2,1,1,4,Needs Attention
2839,3424,154,2,2940.52,1,1,1,3,Require Activation
2840,3425,19,6,6287.459999999999,4,3,3,10,Highly potential
2841,3426,46,6,8405.57,2,3,4,9,Highly potential
2842,3427,2,8,12523.17,4,4,4,12,Highly potential
2843,3428,92,1,1274.93,1,1,1,3,Require Activation
2844,3430,64,7,5809.240000000001,2,3,2,7,Require Activation
2845,3431,29,10,12673.970000000001,3,4,4,11,Highly potential
2846,3432,107,8,9201.85,1,4,4,9,Highly potential
2847,3433,1,10,10471.84,4,4,4,12,Highly potential
2848,3434,65,5,5720.5199999999995,2,2,2,6,Loyal
2849,3435,137,5,6384.0199999999995,1,2,3,6,Loyal
2850,3437,103,5,6930.869999999999,1,2,3,6,Loyal
2851,3438,175,5,5208.01,1,2,2,5,Promising
2852,3439,75,6,5868.209999999999,2,3,2,7,Require Activation
2853,3440,33,5,5026.7,3,2,2,7,Require Activation
2854,3441,139,5,4864.98,1,2,2,5,Promising
2855,3442,204,4,4629.6,1,1,2,4,Needs Attention
2856,3444,40,2,3281.0299999999997,3,1,1,5,Promising
2857,3446,5,2,1028.53,4,1,1,6,Loyal
2858,3448,11,5,5257.04,4,2,2,8,Require Activation
2859,3449,150,4,4223.1900000000005,1,1,2,4,Needs Attention
2860,3450,99,6,7360.7699999999995,1,3,3,7,Require Activation
2861,3451,16,9,7139.170000000001,4,4,3,11,Highly potential
2862,3452,3,2,2808.6800000000003,4,1,1,6,Loyal
2863,3453,73,6,6294.04,2,3,3,8,Require Activation
2864,3454,116,5,5561.379999999999,1,2,2,5,Promising
2865,3455,10,6,4674.13,4,3,2,9,Highly potential
2866,3458,109,3,4554.71,1,1,2,4,Needs Attention
2867,3460,56,9,12544.76,2,4,4,10,Highly potential
2868,3461,137,7,8401.21,1,3,4,8,Require Activation
2869,3462,22,5,5392.75,3,2,2,7,Require Activation
2870,3463,58,4,3021.68,2,1,1,4,Needs Attention
2871,3465,73,10,10063.64,2,4,4,10,Highly potential
2872,3466,69,3,2421.71,2,1,1,4,Needs Attention
2873,3467,6,6,8292.41,4,3,4,11,Highly potential
2874,3468,2,6,6837.77,4,3,3,10,Highly potential
2875,3469,39,3,2349.65,3,1,1,5,Promising
2876,3470,3,8,14126.249999999998,4,4,4,12,Highly potential
2877,3471,149,4,4637.4800000000005,1,1,2,4,Needs Attention
2878,3472,6,6,6900.7,4,3,3,10,Highly potential
2879,3474,72,5,4654.08,2,2,2,6,Loyal
2880,3475,4,4,3785.92,4,1,1,6,Loyal
2881,3477,65,7,8317.98,2,3,4,9,Highly potential
2882,3478,30,6,6445.49,3,3,3,9,Highly potential
2883,3481,55,7,4988.41,2,3,2,7,Require Activation
2884,3482,28,8,11842.05,3,4,4,11,Highly potential
2885,3483,118,6,8078.030000000001,1,3,4,8,Require Activation
2886,3484,80,6,8406.81,2,3,4,9,Highly potential
2887,3485,26,3,3163.31,3,1,1,5,Promising
2888,3486,10,4,4722.08,4,1,2,7,Require Activation
2889,3487,11,3,3715.32,4,1,1,6,Loyal
2890,3488,18,2,2167.79,4,1,1,6,Loyal
2891,3489,109,6,8300.150000000001,1,3,4,8,Require Activation
2892,3490,167,5,4739.7,1,2,2,5,Promising
2893,3491,190,4,3151.67,1,1,1,3,Require Activation
2894,3492,81,3,4141.43,2,1,2,5,Promising
2895,3493,94,6,10053.82,1,3,4,8,Require Activation
2896,3494,5,4,5122.709999999999,4,1,2,7,Require Activation
2897,3495,14,7,8626.65,4,3,4,11,Highly potential
2898,3496,257,4,4725.38,1,1,2,4,Needs Attention
2899,3497,53,3,3744.0699999999997,2,1,1,4,Needs Attention
